Aaien	Aaide	Geaaid
Aanbesterven	Aanbestierf	Aanbestorven
Aanschouwen	Aanschouwde	Aanschouwd
Abandonneren	Abandonneerde	Geabandonneerd
Abonneren	Abonneerde	Geabonneerd
Absenteren	Absenteerde	Geabsenteerd
Abstineren	Abstineerde	Geabstineerd
Accapareren	Accapareerde	Geaccapareerd
Acclimatiseren	Acclimatiseerde	Geacclimatiseerd
Accrediteren	Accrediteerde	Geaccrediteerd
Accrocheren	Accrocheerde	Geaccrocheerd
Achterwaren	Achterwaarde	Achterwaard
Acquireren	Acquireerde	Geacquireerd
Acquitteren	Acquitteerde	Geacquitteerd
Acteren	Acteerde	Geacteerd
Activeren	Activeerde	Geactiveerd
Adelen	Adelde	Geadeld
Aderiseren	Aderiseerde	Geaderiseerd
Admitteren	Admitteerde	Geadmitteerd
Adoniseren	Adoniseerde	Geadoniseerd
Adresseren	Adresseerde	Geadresseerd
Adsorberen	Adsorbeerde	Geadsorbeerd
Aerobiccen	Aerobicte	Geaerobict
Afficheren	Afficheerde	Geafficheerd
Affineren	Affineerde	Geaffineerd
Affirmeren	Affirmeerde	Geaffirmeerd
Afrikaniseren	Afrikaniseerde	Geafrikaniseerd
Agenderen	Agendeerde	Geagendeerd
Aggregeren	Aggregeerde	Geaggregeerd
Agioteren	Agioteerde	Geagioteerd
Agnosceren	Agnosceerde	Geagnosceerd
Akkeren	Akkerde	Geakkerd
Alfabetiseren	Alfabetiseerde	Gealfabetiseerd
Aligneren	Aligneerde	Gealigneerd
Alkaliseren	Alkaliseerde	Gealkaliseerd
Allitereren	Allitereerde	Geallitereerd
Allittereren	Allittereerde	Geallittereerd
Alloceren	Alloceerde	Gealloceerd
Alpineskiën	Alpineskiede	Gealpineskied
Altereren	Altereerde	Gealtereerd
Aluinen	Aluinde	Gealuind
Aluminiseren	Aluminiseerde	Gealuminiseerd
Amalgameren	Amalgameerde	Geamalgameerd
Amenderen	Amendeerde	Geamendeerd
Amerikaniseren	Amerikaniseerde	Geamerikaniseerd
Amplificeren	Amplificeerde	Geamplificeerd
Analyseren	Analyseerde	Geanalyseerd
Anatomiseren	Anatomiseerde	Geanatomiseerd
Annexeren	Annexeerde	Geannexeerd
Annoteren	Annoteerde	Geannoteerd
Anodiseren	Anodiseerde	Geanodiseerd
Anonimiseren	Anonimiseerde	Geanonimiseerd
Antecederen	Antecedeerde	Geantecedeerd
Antedateren	Antedateerde	Geantedateerd
Antichambreren	Antichambreerde	Geantichambreerd
Antidateren	Antidateerde	Geantidateerd
Apaiseren	Apaiseerde	Geapaiseerd
Apocoperen	Apocopeerde	Geapocopeerd
Apparenteren	Apparenteerde	Geapparenteerd
Appliqueren	Appliqueerde	Geappliqueerd
Apporteren	Apporteerde	Geapporteerd
Appreciëren	Apprecieerde	Geapprecieerd
Appreteren	Appreteerde	Geappreteerd
Approvianderen	Approviandeerde	Geapproviandeerd
Après-skiën	Après-skiede	Geaprès-skied
Aquarelleren	Aquarelleerde	Geaquarelleerd
Arabiseren	Arabiseerde	Gearabiseerd
Arbitreren	Arbitreerde	Gearbitreerd
Archaïseren	Archaïseerde	Gearchaïseerd
Archiveren	Archiveerde	Gearchiveerd
Ardoiseren	Ardoiseerde	Geardoiseerd
Aren	Aarde	Geaard
Argwanen	Argwaande	Geargwaand
Aromatiseren	Aromatiseerde	Gearomatiseerd
Arren	Arde	Geard
Articuleren	Articuleerde	Gearticuleerd
Asemen	Asemde	Geasemd
Asfalteren	Asfalteerde	Geasfalteerd
Asfyxiëren	Asfyxieerde	Geasfyxieerd
Assembleren	Assembleerde	Geassembleerd
Asserteren	Asserteerde	Geasserteerd
Assoneren	Assoneerde	Geassoneerd
Assorteren	Assorteerde	Geassorteerd
Assumeren	Assumeerde	Geassumeerd
Atomiseren	Atomiseerde	Geatomiseerd
Atrofiëren	Atrofieerde	Geatrofieerd
Attacheren	Attacheerde	Geattacheerd
Attenderen	Attendeerde	Geattendeerd
Attesteren	Attesteerde	Geattesteerd
Attraperen	Attrapeerde	Geattrapeerd
Auditeren	Auditeerde	Geauditeerd
Ausculteren	Ausculteerde	Geausculteerd
Autodaten	Autodatete	Geautodatet
Automatiseren	Automatiseerde	Geautomatiseerd
Autopetten	Autopette	Geautopet
Avaleren	Avaleerde	Geavaleerd
Avondmalen	Avondmaalde	Geavondmaald
Avonturen	Avontuurde	Geavontuurd
Avonturieren	Avonturierde	Geavonturierd
Azen	Aasde	Geaasd
Baanderen	Baanderde	Gebaanderd
Babysitten	Babysitte	Gebabysit
Back-uppen	Back-upte	Geback-upt
Backen	Backte	Gebackt
Backpacken	Backpackte	Gebackpackt
Badderen	Badderde	Gebadderd
Badineren	Badineerde	Gebadineerd
Badmintonnen	Badmintonde	Gebadmintond
Bagatelliseren	Bagatelliseerde	Gebagatelliseerd
Bakenen	Bakende	Gebakend
Bakkeleien	Bakkeleide	Gebakkeleid
Baksen	Bakste	Gebakst
Balderen	Balderde	Gebalderd
Balen	Baalde	Gebaald
Balkaniseren	Balkaniseerde	Gebalkaniseerd
Ballasten	Ballastte	Geballast
Ballen	Balde	Gebald
Baltsen	Baltste	Gebaltst
Bamzaaien	Bamzaaide	Gebamzaaid
Banderolleren	Banderolleerde	Gebanderolleerd
Banen	Baande	Gebaand
Banjeren	Banjerde	Gebanjerd
Banken	Bankte	Gebankt
Banketteren	Banketteerde	Gebanketteerd
Bankieren	Bankierde	Gebankierd
Banvloeken	Banvloekte	Gebanvloekt
Baratteren	Baratteerde	Gebaratteerd
Barbecueën	Barbecuede	Gebarbecued
Barbieren	Barbierde	Gebarbierd
Barnen	Barnde	Gebarnd
Barreren	Barreerde	Gebarreerd
Baseballen	Baseballde	Gebaseballd
Basen	Basede	Gebased
Basketballen	Basketbalde	Gebasketbald
Basketten	Baskette	Gebasket
Bassen	Baste	Gebast
Bastaarderen	Bastaardeerde	Gebastaardeerd
Batikken	Batikte	Gebatikt
Batten	Batte	Gebat
Bauwen	Bauwde	Gebauwd
Bazen	Baasde	Gebaasd
Beademen	Beademde	Beademd
Beangsten	Beangstte	Beangst
Beangstigen	Beangstigde	Beangstigd
Bearbeiden	Bearbeidde	Bearbeid
Beargumenteren	Beargumenteerde	Beargumenteerd
Beasemen	Beasemde	Beasemd
Bebakenen	Bebakende	Bebakend
Bebinden	Bebond	Bebonden
Beboeren	Beboerde	Beboerd
Beboeten	Beboette	Beboet
Bebossen	Beboste	Bebost
Beboteren	Beboterde	Beboterd
Bebroeden	Bebroedde	Bebroed
Becommentariëren	Becommentarieerde	Becommentarieerd
Beconcurreren	Beconcurreerde	Beconcurreerd
Bedammen	Bedamde	Bedamd
Bedampen	Bedampte	Bedampt
Bedauwen	Bedauwde	Bedauwd
Bedijken	Bedijkte	Bedijkt
Bediscussiëren	Bediscussieerde	Bediscussieerd
Bedisselen	Bedisselde	Bedisseld
Bedoeken	Bedoekte	Bedoekt
Bedoelen	Bedoelde	Bedoeld
Bedoen	Bedeed	Bedaan
Bedonderen	Bedonderde	Bedonderd
Bedrinken	Bedronk	Bedronken
Bedroppelen	Bedroppelde	Bedroppeld
Bedrukken	Bedrukte	Bedrukt
Bedruppelen	Bedruppelde	Bedruppeld
Bedruppen	Bedrupte	Bedrupt
Beduchten	Beduchtte	Beducht
Beduimelen	Beduimelde	Beduimeld
Beeldsnijden		
Beesten	Beestte	Gebeest
Beffen	Befte	Gebeft
Befloersen	Befloerste	Befloerst
Begapen	Begaapte	Begaapt
Begeesteren	Begeesterde	Begeesterd
Begeven	Begaf	Begeven
Begieren	Begierde	Begierd
Begillen	Begilde	Begild
Begrazen	Begraasde	Begraasd
Begrinden	Begrindde	Begrind
Begrinten	Begrintte	Begrint
Begroeien	Begroeide	Begroeid
Begrommen	Begromde	Begromd
Begruizen	Begruisde	Begruisd
Behakken	Behakte	Behakt
Behameren	Behamerde	Behamerd
Behangen	Behing	Behangen
Beharen	Behaarde	Behaard
Behelpen	Behielp	Beholpen
Behelzen	Behelsde	Behelsd
Behouwen	Behieuw	Behouwen
Behuwen	Behuwde	Behuwd
Beiaarden	Beiaardde	Gebeiaard
Beiden	Beidde	Gebeid
Beijveren	Beijverde	Beijverd
Beitelen	Beitelde	Gebeiteld
Bejegenen	Bejegende	Bejegend
Bekabelen	Bekabelde	Bekabeld
Bekaden	Bekaadde	Bekaad
Bekakken	Bekakte	Bekakt
Bekalken	Bekalkte	Bekalkt
Bekamen	Bekaamde	Bekaamd
Bekampen	Bekampte	Bekampt
Bekappen	Bekapte	Bekapt
Be	Bekeerde	Bekeerd
keren	Bekerde	Gebekerd
Bekijven	Bekeef	Bekeven
Bekisten	Bekistte	Bekist
Bekken	Bekte	Gebekt
Beklampen	Beklampte	Beklampt
Beklappen	Beklapte	Beklapt
Beklauteren	Beklauterde	Beklauterd
Bekletsen	Bekletste	Bekletst
Beklinken	Beklonk	Beklonken
Beklonteren	Beklonterde	Beklonterd
Bekloppen	Beklopte	Beklopt
Beknabbelen	Beknabbelde	Beknabbeld
Beknagen	Beknaagde	Beknaagd
Beknellen	Beknelde	Bekneld
Beknibbelen	Beknibbelde	Beknibbeld
Beknijpen	Bekneep	Beknepen
Bekomen	Bekwam	Bekomen
Bekommeren	Bekommerde	Bekommerd
Bekopen	Bekocht	Bekocht
Bekorsten	Bekorstte	Bekorst
Bekostigen	Bekostigde	Bekostigd
Bekrabbelen	Bekrabbelde	Bekrabbeld
Bekrabben	Bekrabde	Bekrabd
Bekrammen	Bekramde	Bekramd
Bekransen	Bekranste	Bekranst
Bekrassen	Bekraste	Bekrast
Bekreunen	Bekreunde	Bekreund
Bekribben	Bekribde	Bekribd
Bekrimpen	Bekromp	Bekrompen
Bekruipen	Bekroop	Bekropen
Bekruisen	Bekruiste	Bekruist
Bekuipen	Bekuipte	Bekuipt
Bekvechten	Bekvechtte	Gebekvecht
Bekwamen	Bekwaamde	Bekwaamd
Bekwijlen	Bekwijlde	Bekwijld
Belagen	Belaagde	Belaagd
Belanden	Belandde	Beland
Belangen	Belangde	Belangd
Belatafelen	Belatafelde	Belatafeld
Belazeren	Belazerde	Belazerd
Belegeren	Belegerde	Belegerd
Belenden	Belendde	Belend
Beleren	Beleerde	Beleerd
Belezen	Belas	Belezen
Belichamen	Belichaamde	Belichaamd
Beliegen	Beloog	Belogen
Believen	Beliefde	Beliefd
Belijden	Beleed	Beleden
Belijmen	Belijmde	Belijmd
Belijnen	Belijnde	Belijnd
Belikken	Belikte	Belikt
Belommeren	Belommerde	Belommerd
Belonken	Belonkte	Belonkt
Beluchten	Beluchtte	Belucht
Beluiden	Beluidde	Beluid
Bemalen	Bemaalde	Bemalen
Bemannen	Bemande	Bemand
Bemasten	Bemastte	Bemast
Bematten	Bematte	Bemat
Bemeesteren	Bemeesterde	Bemeesterd
Bemensen	Bemenste	Bemenst
Bemeubelen	Bemeubelde	Bemeubeld
Bemodderen	Bemodderde	Bemodderd
Bemoederen	Bemoederde	Bemoederd
Bemoeien	Bemoeide	Bemoeid
Bemoeilijken	Bemoeilijkte	Bemoeilijkt
Bemonsteren	Bemonsterde	Bemonsterd
Bemorsen	Bemorste	Bemorst
Bemuren	Bemuurde	Bemuurd
Benaarstigen	Benaarstigde	Benaarstigd
Benaderen	Benaderde	Benaderd
Benagelen	Benagelde	Benageld
Benchmarken	Benchmarkte	Gebenchmarkt
Benemen	Benam	Benomen
Benen	Beende	Gebeend
Benevelen	Benevelde	Beneveld
Bengelen	Bengelde	Gebengeld
Benieuwen	Benieuwde	Benieuwd
Benuttigen	Benuttigde	Benuttigd
Beogen	Beoogde	Beoogd
Beoliën	Beoliede	Beolied
Beoordelen	Beoordeelde	Beoordeeld
Beoorlogen	Beoorloogde	Beoorloogd
Bepakken	Bepakte	Bepakt
Bepantseren	Bepantserde	Bepantserd
Beparelen	Beparelde	Bepareld
Bepeinzen	Bepeinsde	Bepeinsd
Bepekken	Bepekte	Bepekt
Beperken	Beperkte	Beperkt
Bepikken	Bepikte	Bepikt
Beplakken	Beplakte	Beplakt
Beplanken	Beplankte	Beplankt
Beplanten	Beplantte	Beplant
Bepoederen	Bepoederde	Bepoederd
Bepoeieren	Bepoeierde	Bepoeierd
Bepolderen	Bepolderde	Bepolderd
Bepotelen	Bepotelde	Bepoteld
Bepoten	Bepootte	Bepoot
Bepreken	Bepreekte	Bepreekt
Bepruiken	Bepruikte	Bepruikt
Berapen	Beraapte	Beraapt
Beredderen	Beredderde	Beredderd
Beregelen	Beregelde	Beregeld
Beregenen	Beregende	Beregend
Bereizen	Bereisde	Bereisd
Beren	Beerde	Gebeerd
Berennen	Berende	Berend
Berenten	Berentte	Berent
Beridderen	Beridderde	Beridderd
Berijden	Bereed	Bereden
Berijmen	Berijmde	Berijmd
Beringen	Beringde	Beringd
Beroemen	Beroemde	Beroemd
Beroepen	Beriep	Beroepen
Beroken	Berookte	Berookt
Berouwen	Berouwde	Berouwd
Beruiken	Berook	Beroken
Besausen	Besauste	Besaust
Beschaduwen	Beschaduwde	Beschaduwd
Beschansen	Beschanste	Beschanst
Bescheiden	Bescheidde	Bescheiden
Beschenken	Beschonk	Beschonken
Bescheuren	Bescheurde	Bescheurd
Beschijten	Bescheet	Bescheten
Beschilderen	Beschilderde	Beschilderd
Beschoeien	Beschoeide	Beschoeid
Beschreeuwen	Beschreeuwde	Beschreeuwd
Beschreien	Beschreide	Beschreid
Beschrijden	Beschreed	Beschreden
Beschrijven	Beschreef	Beschreven
Besjoemelen	Besjoemelde	Besjoemeld
Beslapen	Besliep	Beslapen
Beslechten	Beslechtte	Beslecht
Besluipen	Besloop	Beslopen
Besmeuren	Besmeurde	Besmeurd
Besnaren	Besnaarde	Besnaard
Besneeuwen	Besneeuwde	Besneeuwd
Besnijden	Besneed	Besneden
Besnuffelen	Besnuffelde	Besnuffeld
Besodemieteren	Besodemieterde	Besodemieterd
Besommen	Besomde	Besomd
Bespatten	Bespatte	Bespat
Bespiegelen	Bespiegelde	Bespiegeld
Bespijkeren	Bespijkerde	Bespijkerd
Bespikkelen	Bespikkelde	Bespikkeld
Bespoelen	Bespoelde	Bespoeld
Besprengen	Besprengde	Besprengd
Bespringen	Besprong	Besprongen
Bespugen	Bespuugde	Bespuugd
Bespuiten	Bespoot	Bespoten
Bespuwen	Bespuwde	Bespuwd
Besteken	Bestak	Bestoken
Bestempelen	Bestempelde	Bestempeld
Bestendigen	Bestendigde	Bestendigd
Besterven	Bestierf	Bestorven
Bestieren	Bestierde	Bestierd
Bestikken	Bestikte	Bestikt
Bestippelen	Bestippelde	Bestippeld
Bestippen	Bestipte	Bestipt
Bestoelen	Bestoelde	Bestoeld
Bestoken	Bestookte	Bestookt
Bestoppen	Bestopte	Bestopt
Bestormen	Bestormde	Bestormd
Bestorten	Bestortte	Bestort
Bestralen	Bestraalde	Bestraald
Bestrijken	Bestreek	Bestreken
Bestrooien	Bestrooide	Bestrooid
Bestuiven	Bestoof	Bestoven
Besuikeren	Besuikerde	Besuikerd
Betegelen	Betegelde	Betegeld
Betelen	Beteelde	Beteeld
Be	Beteerde	Beteerd
teren	Beterde	Gebeterd
Betimmeren	Betimmerde	Betimmerd
Betingelen	Betingelde	Betingeld
Betittelen	Betittelde	Betitteld
Betoelagen	Betoelaagde	Betoelaagd
Betogen	Betoogde	Betoogd
Betonen	Betoonde	Betoond
Betonnen	Betonde	Betond
Betraliën	Betraliede	Betralied
Betreden	Betrad	Betreden
Betrouwen	Betrouwde	Betrouwd
Betuinen	Betuinde	Betuind
Betuttelen	Betuttelde	Betutteld
Betwijfelen	Betwijfelde	Betwijfeld
Beugelen	Beugelde	Gebeugeld
Beugen	Beugde	Gebeugd
Beulen	Beulde	Gebeuld
Beurelen	Beurelde	Gebeureld
Beuzelen	Beuzelde	Gebeuzeld
Bevaren	Bevoer	Bevaren
Bevechten	Bevocht	Bevochten
Bevingeren	Bevingerde	Bevingerd
Bevissen	Beviste	Bevist
Bevitten	Bevitte	Bevit
Bevlaggen	Bevlagde	Bevlagd
Bevliegen	Bevloog	Bevlogen
Bevlijtigen	Bevlijtigde	Bevlijtigd
Bevloeren	Bevloerde	Bevloerd
Bevochten	Bevochtte	Bevocht
Bevolken	Bevolkte	Bevolkt
Bevoogden	Bevoogdde	Bevoogd
Bevoorrechten	Bevoorrechtte	Bevoorrecht
Bevroeden	Bevroedde	Bevroed
Bevruchten	Bevruchtte	Bevrucht
Bewaarheiden	Bewaarheidde	Bewaarheid
Bewallen	Bewalde	Bewald
Bewalmen	Bewalmde	Bewalmd
Bewasemen	Bewasemde	Bewasemd
Bewassen	Bewies	Bewassen
Bewateren	Bewaterde	Bewaterd
Bewegwijzeren	Bewegwijzerde	Bewegwijzerd
Beweiden	Beweidde	Beweid
Bewieroken	Bewierookte	Bewierookt
Bewilligen	Bewilligde	Bewilligd
Bewolken	Bewolkte	Bewolkt
Bewonderen	Bewonderde	Bewonderd
Bezaaien	Bezaaide	Bezaaid
Bezakken	Bezakte	Bezakt
Bezanden	Bezandde	Bezand
Bezatten	Bezatte	Bezat
Bezeilen	Bezeilde	Bezeild
Bezeren	Bezeerde	Bezeerd
Bezeveren	Bezeverde	Bezeverd
Bezichtigen	Bezichtigde	Bezichtigd
Bezien	Bezag	Bezien
Bezigen	Bezigde	Gebezigd
Bezingen	Bezong	Bezongen
Bezinken	Bezonk	Bezonken
Bezinnen	Bezon	Bezonnen
Bezoden	Bezoodde	Bezood
Bezolderen	Bezolderde	Bezolderd
Bezomen	Bezoomde	Bezoomd
Bezondigen	Bezondigde	Bezondigd
Bezuipen	Bezoop	Bezopen
Bezuren	Bezuurde	Bezuurd
Bezwadderen	Bezwadderde	Bezwadderd
Bezwalken	Bezwalkte	Bezwalkt
Bezwangeren	Bezwangerde	Bezwangerd
Bezwaren	Bezwaarde	Bezwaard
Bezwendelen	Bezwendelde	Bezwendeld
Bezweten	Bezweette	Bezweet
Bidden	Bad	Gebeden
Biechten	Biechtte	Gebiecht
Bietsen	Bietste	Gebietst
Biezen	Biesde	Gebiesd
Biggelen	Biggelde	Gebiggeld
Biggen	Bigde	Gebigd
Bikkelen	Bikkelde	Gebikkeld
Biljarten	Biljartte	Gebiljart
Billen	Bilde	Gebild
Bimbammen	Bimbamde	Gebimbamd
Bingoën	Bingode	Gebingood
Bissen	Biste	Gebist
Bisseren	Bisseerde	Gebisseerd
Bitteren	Bitterde	Gebitterd
Bitumineren	Bitumineerde	Gebitumineerd
Bivakkeren	Bivakkeerde	Gebivakkeerd
Blaaskaken	Blaaskaakte	Geblaaskaakt
Bladderen	Bladderde	Gebladderd
Blaffen	Blafte	Geblaft
Blakeren	Blakerde	Geblakerd
Blancheren	Blancheerde	Geblancheerd
Blaren	Blaarde	Geblaard
Blasfemeren	Blasfemeerde	Geblasfemeerd
Blauwbekken	Blauwbekte	Geblauwbekt
Blauwen	Blauwde	Geblauwd
Bleken	Bleekte	Gebleekt
Blekken	Blekte	Geblekt
Blerken	Blerkte	Geblerkt
Blesseren	Blesseerde	Geblesseerd
Blieven	Bliefde	Gebliefd
Blikkeren	Blikkerde	Geblikkerd
Blikogen	Blikoogde	Geblikoogd
Bliktanden	Bliktandde	Gebliktand
Blinddoeken	Blinddoekte	Geblinddoekt
Blinden	Blindde	Geblind
Bloeden	Bloedde	Gebloed
Bloemen	Bloemde	Gebloemd
Bloemlezen	Bloemleesde	Gebloemleesd
Bloesemen	Bloesemde	Gebloesemd
Bloezen	Bloesde	Gebloesd
Bloggen	Blogde	Geblogd
Blokken	Blokte	Geblokt
Blokletteren	Blokletterde	Geblokletterd
Blokzeilen	Blokzeilde	Geblokzeild
Blonderen	Blondeerde	Geblondeerd
Bloten	Blootte	Gebloot
Blouwen	Blouwde	Geblouwd
Blowen	Blowde	Geblowd
Blubberen	Blubberde	Geblubberd
Blunderen	Blunderde	Geblunderd
Blèten	Blètte	Geblèt
Bobbelen	Bobbelde	Gebobbeld
Bobben	Bobde	Gebobd
Bobberen	Bobberde	Gebobberd
Bobijnen	Bobijnde	Gebobijnd
Bobsleeën	Bobsleede	Gebobsleed
Bodemen	Bodemde	Gebodemd
Bodyboarden	Bodyboardde	Gebodyboard
Bodybuilden	Bodybuildde	Gebodybuild
Boegseren	Boegseerde	Geboegseerd
Boeien	Boeide	Geboeid
Boekdrukken		
Boekstaven	Boekstaafde	Geboekstaafd
Boeleren	Boeleerde	Geboeleerd
Boerten	Boertte	Geboert
Boetseren	Boetseerde	Geboetseerd
Bogen	Boogde	Geboogd
Bokken	Bokte	Gebokt
Boksen	Bokste	Gebokst
Bolderen	Bolderde	Gebolderd
Bollen	Bolde	Gebold
Bolsteren	Bolsterde	Gebolsterd
Bolwerken	Bolwerkte	Gebolwerkt
Bomberen	Bombeerde	Gebombeerd
Bomchecken	Bomcheckte	Gebomcheckt
Bomen	Boomde	Geboomd
Bommelen	Bommelde	Gebommeld
Bommen	Bomde	Gebomd
Bonjouren	Bonjourde	Gebonjourd
Boodschappen	Boodschapte	Geboodschapt
Boorden	Boordde	Geboord
Booten	Bootte	Geboot
Bootsen	Bootste	Gebootst
Borduren	Borduurde	Geborduurd
Boren	Boorde	Geboord
Borgen	Borgde	Geborgd
Borneren	Borneerde	Geborneerd
Bosseleren	Bosseleerde	Gebosseleerd
Bossen	Boste	Gebost
Bostonnen	Bostonde	Gebostond
Bostonneren	Bostonneerde	Gebostonneerd
Botaniseren	Botaniseerde	Gebotaniseerd
Boten	Bootte	Geboot
Boteren	Boterde	Geboterd
Botsen	Botste	Gebotst
Bouderen	Boudeerde	Geboudeerd
Bowlen	Bowlde	Gebowld
Boycotten	Boycotte	Geboycot
Brabbelen	Brabbelde	Gebrabbeld
Brainstormen	Brainstormde	Gebrainstormd
Brainwashen	Brainwashte	Gebrainwasht
Brallen	Bralde	Gebrald
Brandmerken	Brandmerkte	Gebrandmerkt
Brandschatten	Brandschatte	Gebrandschat
Brandschilderen	Brandschilderde	Gebrandschilderd
Braniën	Braniede	Gebranied
Braveren	Braveerde	Gebraveerd
Breakdancen	Breakdancete	Gebreakdancet
Breakdansen	Breakdanste	Gebreakdanst
Breidelen	Breidelde	Gebreideld
Breien	Breide	Gebreid
Brevetteren	Brevetteerde	Gebrevetteerd
Brevieren	Brevierde	Gebrevierd
Bricoleren	Bricoleerde	Gebricoleerd
Bridgen	Bridgede	Gebridged
Briefen	Briefte	Gebrieft
Brijnen	Brijnde	Gebrijnd
Brijzelen	Brijzelde	Gebrijzeld
Brillen	Brilde	Gebrild
Britsen	Britste	Gebritst
Broddelen	Broddelde	Gebroddeld
Brodden	Brodde	Gebrod
Brokkelen	Brokkelde	Gebrokkeld
Brokken	Brokte	Gebrokt
Bronzen	Bronsde	Gebronsd
Broodroven	Broodroofde	Gebroodroofd
Brossen	Broste	Gebrost
Brouilleren	Brouilleerde	Gebrouilleerd
Brouwen	Brouwde	Gebrouwd
Brouwen	Brouwde	Gebrouwen
Browsen	Browsete	Gebrowset
Bruineren	Bruineerde	Gebruineerd
Brunchen	Brunchte	Gebruncht
Brutaliseren	Brutaliseerde	Gebrutaliseerd
Bruuskeren	Bruuskeerde	Gebruuskeerd
Bubbelen	Bubbelde	Gebubbeld
Budgetteren	Budgetteerde	Gebudgetteerd
Buffelen	Buffelde	Gebuffeld
Bufferen	Bufferde	Gebufferd
Buien	Buide	Gebuid
Builen	Builde	Gebuild
Buizen	Buisde	Gebuisd
Bulldozeren	Bulldozerde	Gebulldozerd
Bulten	Bultte	Gebult
Bundelen	Bundelde	Gebundeld
Bungelen	Bungelde	Gebungeld
Bureaucratiseren	Bureaucratiseerde	Gebureaucratiseerd
Buren	Buurde	Gebuurd
Burlen	Burlde	Geburld
Busselen	Busselde	Gebusseld
Bussen	Buste	Gebust
Buten	Buutte	Gebuut
Butsen	Butste	Gebutst
Buurten	Buurtte	Gebuurt
Cachetteren	Cachetteerde	Gecachetteerd
Cadanceren	Cadanceerde	Gecadanceerd
Calcineren	Calcineerde	Gecalcineerd
Cancelen	Cancelde	Gecanceld
Cancellen	Cancelde	Gecanceld
Canneleren	Canneleerde	Gecanneleerd
Canoniseren	Canoniseerde	Gecanoniseerd
Canvassen	Canvaste	Gecanvast
Capitonneren	Capitonneerde	Gecapitonneerd
Capteren	Capteerde	Gecapteerd
Carpoolen	Carpoolde	Gecarpoold
Casseren	Casseerde	Gecasseerd
Casten	Castte	Gecast
Castigeren	Castigeerde	Gecastigeerd
Catalogeren	Catalogeerde	Gecatalogeerd
Catalogiseren	Catalogiseerde	Gecatalogiseerd
Catechiseren	Catechiseerde	Gecatechiseerd
Categoriseren	Categoriseerde	Gecategoriseerd
Cauteriseren	Cauteriseerde	Gecauteriseerd
Cederen	Cedeerde	Gecedeerd
Cementen	Cementte	Gecement
Censeren	Censeerde	Gecenseerd
Centeren	Centerde	Gecenterd
Centrifugeren	Centrifugeerde	Gecentrifugeerd
Chambreren	Chambreerde	Gechambreerd
Changeren	Changeerde	Gechangeerd
Chanteren	Chanteerde	Gechanteerd
Chaperonneren	Chaperonneerde	Gechaperonneerd
Chargen	Chargede	Gecharged
Chatten	Chatte	Gechat
Chicaneren	Chicaneerde	Gechicaneerd
Chinezen	Chineesde	Gechineesd
Chippen	Chipte	Chipt
Chloren	Chloorde	Gechloord
Chloreren	Chloreerde	Gechloreerd
Chloroformeren	Chloroformeerde	Gechloroformeerd
Choreograferen	Choreografeerde	Gechoreografeerd
Chromeren	Chromeerde	Gechromeerd
Chronometreren	Chronometreerde	Gechronometreerd
Cijferen	Cijferde	Gecijferd
Cirkelen	Cirkelde	Gecirkeld
Ciseleren	Ciseleerde	Geciseleerd
Clausuleren	Clausuleerde	Geclausuleerd
Clicheren	Clicheerde	Geclicheerd
Clusteren	Clusterde	Geclusterd
Co-existeren	Co-existeerde	Geco-existeerd
Coaten	Coatte	Gecoat
Cocoonen	Cocoonde	Gecocoond
Codificeren	Codificeerde	Gecodificeerd
Cohabiteren	Cohabiteerde	Gecohabiteerd
Coifferen	Coiffeerde	Gecoiffeerd
Collaboreren	Collaboreerde	Gecollaboreerd
Collationeren	Collationeerde	Gecollationeerd
Collectioneren	Collectioneerde	Gecollectioneerd
Collectiviseren	Collectiviseerde	Gecollectiviseerd
Collideren	Collideerde	Gecollideerd
Commentariëren	Commentarieerde	Gecommentarieerd
Commercialiseren	Commercialiseerde	Gecommercialiseerd
Committeren	Committeerde	Gecommitteerd
Communiceren	Communiceerde	Gecommuniceerd
Compareren	Compareerde	Gecompareerd
Competeren	Competeerde	Gecompeteerd
Complementeren	Complementeerde	Gecomplementeerd
Complimenteren	Complimenteerde	Gecomplimenteerd
Complotteren	Complotteerde	Gecomplotteerd
Composteren	Composteerde	Gecomposteerd
Comprimeren	Comprimeerde	Gecomprimeerd
Computeren	Computerde	Gecomputerd
Computeriseren	Computeriseerde	Gecomputeriseerd
Concelebreren	Concelebreerde	Geconcelebreerd
Concerteren	Concerteerde	Geconcerteerd
Conciliëren	Concilieerde	Geconcilieerd
Concipiëren	Concipieerde	Geconcipieerd
Concorderen	Concordeerde	Geconcordeerd
Condenseren	Condenseerde	Gecondenseerd
Condoleren	Condoleerde	Gecondoleerd
Confectioneren	Confectioneerde	Geconfectioneerd
Confedereren	Confedereerde	Geconfedereerd
Confereren	Confereerde	Geconfereerd
Configureren	Configureerde	Geconfigureerd
Confirmeren	Confirmeerde	Geconfirmeerd
Conflicteren	Conflicteerde	Geconflicteerd
Conformeren	Conformeerde	Geconformeerd
Confronteren	Confronteerde	Geconfronteerd
Congresseren	Congresseerde	Gecongresseerd
Congrueren	Congrueerde	Gecongrueerd
Consenteren	Consenteerde	Geconsenteerd
Consigneren	Consigneerde	Geconsigneerd
Conspireren	Conspireerde	Geconspireerd
Constitueren	Constitueerde	Geconstitueerd
Contacteren	Contacteerde	Gecontacteerd
Contamineren	Contamineerde	Gecontamineerd
Contesteren	Contesteerde	Gecontesteerd
Contingenteren	Contingenteerde	Gecontingenteerd
Continueren	Continueerde	Gecontinueerd
Contraheren	Contraheerde	Gecontraheerd
Contrariëren	Contrarieerde	Gecontrarieerd
Contrasigneren	Contrasigneerde	Gecontrasigneerd
Contribueren	Contribueerde	Gecontribueerd
Conveniëren	Convenieerde	Geconvenieerd
Converseren	Converseerde	Geconverseerd
Coproduceren	Coproduceerde	Gecoproduceerd
Copuleren	Copuleerde	Gecopuleerd
Correctionaliseren	Correctionaliseerde	Gecorrectionaliseerd
Correleren	Correleerde	Gecorreleerd
Corresponderen	Correspondeerde	Gecorrespondeerd
Corrumperen	Corrumpeerde	Gecorrumpeerd
Corveeën	Corveede	Gecorveed
Counselen	Counselde	Gecounseld
Counteren	Counterde	Gecounterd
Countrydansen	Countrydanste	Gecountrydanst
Coupen	Coupte	Gecoupt
Coveren	Coverde	Gecoverd
Coïncideren	Coïncideerde	Gecoïncideerd
Coïteren	Coïteerde	Gecoïteerd
Coöpereren	Coöpereerde	Gecoöpereerd
Coöpteren	Coöpteerde	Gecoöpteerd
Coördineren	Coördineerde	Gecoördineerd
Crashen	Crashte	Gecrasht
Crawlen	Crawlde	Gecrawld
Creosoteren	Creosoteerde	Gecreosoteerd
Cricketen	Crickette	Gecricket
Criminaliseren	Criminaliseerde	Gecriminaliseerd
Croonen	Croonde	Gecroond
Crossen	Croste	Gecrost
Crowdsurfen	Crowdsurfte	Gecrowdsurft
Culmineren	Culmineerde	Geculmineerd
Culpabiliseren	Culpabiliseerde	Geculpabiliseerd
Cultiveren	Cultiveerde	Gecultiveerd
Cumuleren	Cumuleerde	Gecumuleerd
Curetteren	Curetteerde	Gecuretteerd
Cursiveren	Cursiveerde	Gecursiveerd
Cyclecrossen	Cyclecroste	Gecyclecrost
Cyclocrossen	Cyclocroste	Gecyclocrost
Cyclostyleren	Cyclostyleerde	Gecyclostyleerd
Dabben	Dabde	Gedabd
Dactyloscoperen	Dactyloscopeerde	Gedactyloscopeerd
Dagdieven	Dagdiefde	Gedagdiefd
Dagdromen	Dagdroomde	Gedagdroomd
Dagvaarden	Dagvaardde	Gedagvaard
Dalven	Dalfde	Gedalfd
Damasceren	Damasceerde	Gedamasceerd
Dammen	Damde	Gedamd
Dampen	Dampte	Gedampt
Dansen	Danste	Gedanst
Darren	Darde	Gedard
Darten	Dartte	Gedart
Daten	Datete	Gedatet
Dauwen	Dauwde	Gedauwd
Davvenen	Davvende	Gedavvend
Dazen	Daasde	Gedaasd
De-escaleren	De-escaleerde	Gede-escaleerd
Deactualiseren	Deactualiseerde	Gedeactualiseerd
Dealen	Dealde	Gedeald
Deballoteren	Deballoteerde	Gedeballoteerd
Debarkeren	Debarkeerde	Gedebarkeerd
Debatteren	Debatteerde	Gedebatteerd
Deblokkeren	Deblokkeerde	Gedeblokkeerd
Debrailleren	Debrailleerde	Gedebrailleerd
Debrayeren	Debrayeerde	Gedebrayeerd
Debriefen	Debriefte	Gedebrieft
Debuggen	Debugde	Gedebugd
Debuteren	Debuteerde	Gedebuteerd
Decentraliseren	Decentraliseerde	Gedecentraliseerd
Dechargeren	Dechargeerde	Gedechargeerd
Decideren	Decideerde	Gedecideerd
Decimeren	Decimeerde	Gedecimeerd
Declameren	Declameerde	Gedeclameerd
Declasseren	Declasseerde	Gedeclasseerd
Decoderen	Decodeerde	Gedecodeerd
Decomprimeren	Decomprimeerde	Gedecomprimeerd
Deconfessionaliseren	Deconfessionaliseerde	Gedeconfessionaliseerd
Deconstrueren	Deconstrueerde	Gedeconstrueerd
Decouperen	Decoupeerde	Gedecoupeerd
Decreteren	Decreteerde	Gedecreteerd
Deeplinken	Deeplinkte	Gedeeplinkt
Defibrilleren	Defibrilleerde	Gedefibrilleerd
Defileren	Defileerde	Gedefileerd
Deflecteren	Deflecteerde	Gedeflecteerd
Defloreren	Defloreerde	Gedefloreerd
Deformeren	Deformeerde	Gedeformeerd
Defragmenteren	Defragmenteerde	Gedefragmenteerd
Deglaceren	Deglaceerde	Gedeglaceerd
Degusteren	Degusteerde	Gedegusteerd
Dehydreren	Dehydreerde	Gedehydreerd
Deinen	Deinde	Gedeind
Deinzen	Deinsde	Gedeinsd
Dejeuneren	Dejeuneerde	Gedejeuneerd
Dekoloniseren	Dekoloniseerde	Gedekoloniseerd
Deleten	Deletete	Gedeletet
Delibereren	Delibereerde	Gedelibereerd
Demagnetiseren	Demagnetiseerde	Gedemagnetiseerd
Demarqueren	Demarqueerde	Gedemarqueerd
Demarreren	Demarreerde	Gedemarreerd
Demaskeren	Demaskeerde	Gedemaskeerd
Dementeren	Dementeerde	Gedementeerd
Demilitariseren	Demilitariseerde	Gedemilitariseerd
Demineraliseren	Demineraliseerde	Gedemineraliseerd
Demobiliseren	Demobiliseerde	Gedemobiliseerd
Democratiseren	Democratiseerde	Gedemocratiseerd
Demoniseren	Demoniseerde	Gedemoniseerd
Demonstreren	Demonstreerde	Gedemonstreerd
Demotiveren	Demotiveerde	Gedemotiveerd
Demystificeren	Demystificeerde	Gedemystificeerd
Denationaliseren	Denationaliseerde	Gedenationaliseerd
Denaturaliseren	Denaturaliseerde	Gedenaturaliseerd
Denatureren	Denatureerde	Gedenatureerd
Denderen	Denderde	Gedenderd
Denigreren	Denigreerde	Gedenigreerd
Denivelleren	Denivelleerde	Gedenivelleerd
Denken	Dacht	Gedacht
Denomineren	Denomineerde	Gedenomineerd
Denonceren	Denonceerde	Gedenonceerd
Denunciëren	Denuncieerde	Gedenuncieerd
Deodoriseren	Deodoriseerde	Gedeodoriseerd
Depanneren	Depanneerde	Gedepanneerd
Depenaliseren	Depenaliseerde	Gedepenaliseerd
Depersonaliseren	Depersonaliseerde	Gedepersonaliseerd
Depolariseren	Depolariseerde	Gedepolariseerd
Depolitiseren	Depolitiseerde	Gedepolitiseerd
Deporteren	Deporteerde	Gedeporteerd
Depouilleren	Depouilleerde	Gedepouilleerd
Depreciëren	Deprecieerde	Gedeprecieerd
Deprivatiseren	Deprivatiseerde	Gedeprivatiseerd
Depriveren	Depriveerde	Gedepriveerd
Deprogrammeren	Deprogrammeerde	Gedeprogrammeerd
Derailleren	Derailleerde	Gederailleerd
Derangeren	Derangeerde	Gederangeerd
Dereguleren	Dereguleerde	Gedereguleerd
Derogeren	Derogeerde	Gederogeerd
Derven	Derfde	Gederfd
Desacraliseren	Desacraliseerde	Gedesacraliseerd
Desambigueren	Desambigueerde	Gedesambigueerd
Desavoueren	Desavoueerde	Gedesavoueerd
Desemen	Desemde	Gedesemd
Desensibiliseren	Desensibiliseerde	Gedesensibiliseerd
Deserteren	Deserteerde	Gedeserteerd
Desinvesteren	Desinvesteerde	Gedesinvesteerd
Desorganiseren	Desorganiseerde	Gedesorganiseerd
Desoriënteren	Desoriënteerde	Gedesoriënteerd
Dessineren	Dessineerde	Gedessineerd
Destabiliseren	Destabiliseerde	Gedestabiliseerd
Destaliniseren	Destaliniseerde	Gedestaliniseerd
Detacheren	Detacheerde	Gedetacheerd
Detailleren	Detailleerde	Gedetailleerd
Detecteren	Detecteerde	Gedetecteerd
Detoneren	Detoneerde	Gedetoneerd
Deuken	Deukte	Gedeukt
Deunen	Deunde	Gedeund
Deuviken	Deuvikte	Gedeuvikt
Devalueren	Devalueerde	Gedevalueerd
Deviëren	Devieerde	Gedevieerd
Diaboliseren	Diaboliseerde	Gediaboliseerd
Diagnosticeren	Diagnosticeerde	Gediagnosticeerd
Dialogiseren	Dialogiseerde	Gedialogiseerd
Dicteren	Dicteerde	Gedicteerd
Dieken	Diekte	Gediekt
Diepen	Diepte	Gediept
Dieplinken	Dieplinkte	Gedieplinkt
Diepvriezen		Diepgevroren
Dieselen	Dieselde	Gedieseld
Dieven	Diefde	Gediefd
Diffameren	Diffameerde	Gediffameerd
Diftongeren	Diftongeerde	Gediftongeerd
Digitaliseren	Digitaliseerde	Gedigitaliseerd
Dijen	Dijde	Gedijd
Dijken	Dijkte	Gedijkt
Dikken	Dikte	Gedikt
Dilateren	Dilateerde	Gedilateerd
Dimensioneren	Dimensioneerde	Gedimensioneerd
Dimmen	Dimde	Gedimd
Dineren	Dineerde	Gedineerd
Dingen	Dong	Gedongen
Diplomeren	Diplomeerde	Gediplomeerd
Dippen	Dipte	Gedipt
Disambigueren	Disambigueerde	Gedisambigueerd
Disciplineren	Disciplineerde	Gedisciplineerd
Disconteren	Disconteerde	Gedisconteerd
Discrediteren	Discrediteerde	Gediscrediteerd
Discrimineren	Discrimineerde	Gediscrimineerd
Disculperen	Disculpeerde	Gedisculpeerd
Discussiëren	Discussieerde	Gediscussieerd
Disfunctioneren	Disfunctioneerde	Gedisfunctioneerd
Disharmoniëren	Disharmonieerde	Gedisharmonieerd
Diskwalificeren	Diskwalificeerde	Gediskwalificeerd
Dispenseren	Dispenseerde	Gedispenseerd
Distantiëren	Distantieerde	Gedistantieerd
Distingeren	Distingeerde	Gedistingeerd
Diversifiëren	Diversifieerde	Gediversifieerd
Diverteren	Diverteerde	Gediverteerd
Djakken	Djakte	Gedjakt
Djorken	Djorkte	Gedjorkt
Dobbelen	Dobbelde	Gedobbeld
Doceren	Doceerde	Gedoceerd
Doctoreren	Doctoreerde	Gedoctoreerd
Documenteren	Documenteerde	Gedocumenteerd
Dodijnen	Dodijnde	Gedodijnd
Doedelen	Doedelde	Gedoedeld
Doelen	Doelde	Gedoeld
Doelpunten	Doelpuntte	Gedoelpunt
Doemen	Doemde	Gedoemd
Doffen	Dofte	Gedoft
Dogmatiseren	Dogmatiseerde	Gedogmatiseerd
Dokkeren	Dokkerde	Gedokkerd
Dokteren	Dokterde	Gedokterd
Doleren	Doleerde	Gedoleerd
Dollariseren	Dollariseerde	Gedollariseerd
Dollen	Dolde	Gedold
Domen	Doomde	Gedoomd
Domesticeren	Domesticeerde	Gedomesticeerd
Domiciliëren	Domicilieerde	Gedomicilieerd
Dominoën	Dominode	Gedominood
Dommelen	Dommelde	Gedommeld
Dompen	Dompte	Gedompt
Donderjagen	Donderjaagde	Gedonderjaagd
Donderstralen	Donderstraalde	Gedonderstraald
Doneren	Doneerde	Gedoneerd
Donkeren	Donkerde	Gedonkerd
Doodverven	Doodverfde	Gedoodverfd
Dooraderen	Dooraderde	Dooraderd
Doorbehandelen	Doorbehandelde	Doorbehandeld
Door	Doorbloedde	Doorbloed
Doordesemen	Doordesemde	Doordesemd
Doorkruiden	Doorkruidde	Doorkruid
Doorschouwen	Doorschouwde	Doorschouwd
Doorspekken	Doorspekte	Doorspekt
Doorstralen	Doorstraalde	Doorstraald
Doortintelen	Doortintelde	Doortinteld
Doorvertellen	Doorvertelde	Doorverteld
Doorvlijmen	Doorvlijmde	Doorvlijmd
Doorvoelen	Doorvoelde	Doorvoeld
Doorvorsen	Doorvorste	Doorvorst
Doorwaken	Doorwaakte	Doorwaakt
Doorwarmen	Doorwarmde	Doorwarmd
Doorwoelen	Doorwoelde	Doorwoeld
Doorwonden	Doorwondde	Doorwond
Doorzwikken	Doorzwikte	Doorzwikt
Dopen	Doopte	Gedoopt
Dorren	Dorde	Gedord
Dorsten	Dorstte	Gedorst
Doseren	Doseerde	Gedoseerd
Dossen	Doste	Gedost
Doteren	Doteerde	Gedoteerd
Dotteren	Dotterde	Gedotterd
Doubleren	Doubleerde	Gedoubleerd
Douchen	Douchte	Gedoucht
Dralen	Draalde	Gedraald
Dramatiseren	Dramatiseerde	Gedramatiseerd
Drammen	Dramde	Gedramd
Draperen	Drapeerde	Gedrapeerd
Dreggen	Dregde	Gedregd
Dreinen	Dreinde	Gedreind
Drenken	Drenkte	Gedrenkt
Drenzen	Drensde	Gedrensd
Dretsen	Dretste	Gedretst
Dreutelen	Dreutelde	Gedreuteld
Drevelen	Drevelde	Gedreveld
Driegen	Driegde	Gedriegd
Droedelen	Droedelde	Gedroedeld
Drogeren	Drogeerde	Gedrogeerd
Dromen	Droomde	Gedroomd
Drommen	Dromde	Gedromd
Droppelen	Droppelde	Gedroppeld
Droppen	Dropte	Gedropt
Drossen	Droste	Gedrost
Drozen	Droosde	Gedroosd
Druiloren	Druiloorde	Gedruiloord
Druipstaarten	Druipstaartte	Gedruipstaart
Druisen	Druiste	Gedruist
Drummen	Drumde	Gedrumd
Druppelen	Druppelde	Gedruppeld
Druppen	Drupte	Gedrupt
Dubbelen	Dubbelde	Gedubbeld
Duelleren	Duelleerde	Geduelleerd
Duimen	Duimde	Geduimd
Duisteren	Duisterde	Geduisterd
Duivelen	Duivelde	Geduiveld
Duizelen	Duizelde	Geduizeld
Dumpen	Dumpte	Gedumpt
Dunken	Docht	Gedocht
Dunnen	Dunde	Gedund
Duperen	Dupeerde	Gedupeerd
Duvelen	Duvelde	Geduveld
Dwarrelen	Dwarrelde	Gedwarreld
Dwarsen	Dwarste	Dwarst
Dweilen	Dweilde	Gedweild
Dwepen	Dweepte	Gedweept
E-mailen	E-mailde	Ge-e-maild
Ebaucheren	Ebaucheerde	Geëbaucheerd
Ebben	Ebde	Geëbd
Ecarteren	Ecarteerde	Geëcarteerd
Echelonneren	Echelonneerde	Geëchelonneerd
Echoën	Echode	Geëchood
Eclipseren	Eclipseerde	Geëclipseerd
Economiseren	Economiseerde	Geëconomiseerd
Eenendertigen	Eenendertigde	Geëenendertigd
Eenentwintigen	Eenentwintigde	Geëenentwintigd
Eesten	Eestte	Geëest
Effectueren	Effectueerde	Geëffectueerd
Egaliseren	Egaliseerde	Geëgaliseerd
Eggen	Egde	Geëgd
Eigenen	Eigende	Geëigend
Einden	Eindde	Geëind
Ejaculeren	Ejaculeerde	Geëjaculeerd
Elektrificeren	Elektrificeerde	Geëlektrificeerd
Elektriseren	Elektriseerde	Geëlektriseerd
Elektrocuteren	Elektrocuteerde	Geëlektrocuteerd
Elideren	Elideerde	Geëlideerd
Emailleren	Emailleerde	Geëmailleerd
Embarkeren	Embarkeerde	Geëmbarkeerd
Emenderen	Emendeerde	Geëmendeerd
Emmeren	Emmerde	Geëmmerd
Emotioneren	Emotioneerde	Geëmotioneerd
Emulgeren	Emulgeerde	Geëmulgeerd
Encadreren	Encadreerde	Geëncadreerd
Encanailleren	Encanailleerde	Geëncanailleerd
Enerveren	Enerveerde	Geënerveerd
Enquêteren	Enquêteerde	Geënquêteerd
Ensceneren	Ensceneerde	Geënsceneerd
Entameren	Entameerde	Geëntameerd
Enteren	Enterde	Geënterd
Entertainen	Entertainde	Geëntertaind
Entraineren	Entraineerde	Geëntraineerd
Epateren	Epateerde	Geëpateerd
Epibreren	Epibreerde	Geëpibreerd
Epileren	Epileerde	Geëpileerd
Equiperen	Equipeerde	Geëquipeerd
Erbarmen	Erbarmde	Erbarmd
Erlangen	Erlangde	Erlangd
Erotiseren	Erotiseerde	Geërotiseerd
Escamoteren	Escamoteerde	Geëscamoteerd
Eskimoteren	Eskimoteerde	Geëskimoteerd
Essayeren	Essayeerde	Geëssayeerd
Esthetiseren	Esthetiseerde	Geësthetiseerd
Etiketteren	Etiketteerde	Geëtiketteerd
Etsen	Etste	Geëtst
Etymologiseren	Etymologiseerde	Geëtymologiseerd
Europeaniseren	Europeaniseerde	Geëuropeaniseerd
Euthanaseren	Euthanaseerde	Geëuthanaseerd
Evalueren	Evalueerde	Geëvalueerd
Evangeliseren	Evangeliseerde	Geëvangeliseerd
Evaporeren	Evaporeerde	Geëvaporeerd
Evenaren	Evenaarde	Geëvenaard
Evoceren	Evoceerde	Geëvoceerd
Evoqueren	Evoqueerde	Geëvoqueerd
Exalteren	Exalteerde	Geëxalteerd
Excelleren	Excelleerde	Geëxcelleerd
Exciteren	Exciteerde	Geëxciteerd
Excommuniceren	Excommuniceerde	Geëxcommuniceerd
Exerceren	Exerceerde	Geëxerceerd
Exhiberen	Exhibeerde	Geëxhibeerd
Existeren	Existeerde	Geëxisteerd
Expatriëren	Expatrieerde	Geëxpatrieerd
Expediëren	Expedieerde	Geëxpedieerd
Experimenteren	Experimenteerde	Geëxperimenteerd
Expireren	Expireerde	Geëxpireerd
Expliceren	Expliceerde	Geëxpliceerd
Expliciteren	Expliciteerde	Geëxpliciteerd
Expliqueren	Expliqueerde	Geëxpliqueerd
Exploderen	Explodeerde	Geëxplodeerd
Exponeren	Exponeerde	Geëxponeerd
Extensiveren	Extensiveerde	Geëxtensiveerd
Extraheren	Extraheerde	Geëxtraheerd
Extrapoleren	Extrapoleerde	Geëxtrapoleerd
Extruderen	Extrudeerde	Geëxtrudeerd
Ezelen	Ezelde	Geëzeld
Fabelen	Fabelde	Gefabeld
Fabrieken	Fabriekte	Gefabriekt
Fabrikeren	Fabrikeerde	Gefabrikeerd
Fabuleren	Fabuleerde	Gefabuleerd
Faceliften	Faceliftte	Gefacelift
Factureren	Factureerde	Gefactureerd
Failleren	Failleerde	Gefailleerd
Faken	Fakete	Gefaket
Falen	Faalde	Gefaald
Falsificeren	Falsificeerde	Gefalsificeerd
Falsifiëren	Falsifieerde	Gefalsifieerd
Fantaseren	Fantaseerde	Gefantaseerd
Farceren	Farceerde	Gefarceerd
Faseren	Faseerde	Gefaseerd
Fatsoeneren	Fatsoeneerde	Gefatsoeneerd
Favoriseren	Favoriseerde	Gefavoriseerd
Faxen	Faxte	Gefaxt
Federaliseren	Federaliseerde	Gefederaliseerd
Federeren	Federeerde	Gefedereerd
Feesten	Feestte	Gefeest
Feilen	Feilde	Gefeild
Felsen	Felste	Gefelst
Femelen	Femelde	Gefemeld
Festonneren	Festonneerde	Gefestonneerd
Fezelen	Fezelde	Gefezeld
Fiatteren	Fiatteerde	Gefiatteerd
Fibrilleren	Fibrilleerde	Gefibrilleerd
Ficheren	Ficheerde	Geficheerd
Fictionaliseren	Fictionaliseerde	Gefictionaliseerd
Fiedelen	Fiedelde	Gefiedeld
Fielden	Fieldde	Gefield
Fierljeppen	Fierljepte	Gefierljept
Fietscrossen	Fietscroste	Gefietscrost
Fietsen	Fietste	Gefietst
Figgelen	Figgelde	Gefiggeld
Figuurzagen	Figuurzaagde	Gefiguurzaagd
Fijfelen	Fijfelde	Gefijfeld
Fikfakken	Fikfakte	Gefikfakt
Fikken	Fikte	Gefikt
Fiksen	Fikste	Gefikst
Fileren	Fileerde	Gefileerd
Filibusteren	Filibusterde	Gefilibusterd
Filosoferen	Filosofeerde	Gefilosofeerd
Finaliseren	Finaliseerde	Gefinaliseerd
Financieren	Financierde	Gefinancierd
Finetunen	Finetunede	Gefinetuned
Finishen	Finishte	Gefinisht
Fiscaliseren	Fiscaliseerde	Gefiscaliseerd
Fistfucken	Fistfuckte	Gefistfuckt
Fitnessen	Fitneste	Gefitnest
Flabberen	Flabberde	Geflabberd
Flamberen	Flambeerde	Geflambeerd
Flankeren	Flankeerde	Geflankeerd
Flansen	Flanste	Geflanst
Flappen	Flapte	Geflapt
Flapperen	Flapperde	Geflapperd
Flatteren	Flatteerde	Geflatteerd
Flecteren	Flecteerde	Geflecteerd
Fleetracen	Fleetracete	Gefleetracet
Flensen	Flenste	Geflenst
Flenzen	Flensde	Geflensd
Fleren	Fleerde	Gefleerd
Flessen	Fleste	Geflest
Fleuren	Fleurde	Gefleurd
Flexibiliseren	Flexibiliseerde	Geflexibiliseerd
Flippen	Flipte	Geflipt
Flipperen	Flipperde	Geflipperd
Flitten	Flitte	Geflit
Flodderen	Flodderde	Geflodderd
Floepen	Floepte	Gefloept
Floppen	Flopte	Geflopt
Flossen	Floste	Geflost
Fluimen	Fluimde	Gefluimd
Fluoresceren	Fluoresceerde	Gefluoresceerd
Fluorideren	Fluorideerde	Gefluorideerd
Fnuiken	Fnuikte	Gefnuikt
Focussen	Focuste	Gefocust
Focusseren	Focusseerde	Gefocusseerd
Foefelen	Foefelde	Gefoefeld
Foelien	Foeliede	Gefoelied
Foerageren	Foerageerde	Gefoerageerd
Foeteren	Foeterde	Gefoeterd
Foezelen	Foezelde	Gefoezeld
Foliëren	Folieerde	Gefolieerd
Fomenteren	Fomenteerde	Gefomenteerd
Fonduen	Fonduede	Gefonduud
Forenzen	Forensde	Geforensd
Formaliseren	Formaliseerde	Geformaliseerd
Formatteren	Formatteerde	Geformatteerd
Formuleren	Formuleerde	Geformuleerd
Fosforesceren	Fosforesceerde	Gefosforesceerd
Fotokopiëren	Fotokopieerde	Gefotokopieerd
Fouilleren	Fouilleerde	Gefouilleerd
Foxtrotten	Foxtrotte	Gefoxtrot
Fractioneren	Fractioneerde	Gefractioneerd
Fragmenteren	Fragmenteerde	Gefragmenteerd
Frankeren	Frankeerde	Gefrankeerd
Frapperen	Frappeerde	Gefrappeerd
Fraseren	Fraseerde	Gefraseerd
Frazelen	Frazelde	Gefrazeld
Freewheelen	Freewheelde	Gefreewheeld
Frequenteren	Frequenteerde	Gefrequenteerd
Fretten	Frette	Gefret
Frezen	Freesde	Gefreesd
Frictioneren	Frictioneerde	Gefrictioneerd
Friemelen	Friemelde	Gefriemeld
Frijnen	Frijnde	Gefrijnd
Frituren	Frituurde	Gefrituurd
Fronselen	Fronselde	Gefronseld
Frotteren	Frotteerde	Gefrotteerd
Fruiten	Fruitte	Gefruit
Frunniken	Frunnikte	Gefrunnikt
Frustreren	Frustreerde	Gefrustreerd
Frutselen	Frutselde	Gefrutseld
Fungeren	Fungeerde	Gefungeerd
Fuseren	Fuseerde	Gefuseerd
Fusilleren	Fusilleerde	Gefusilleerd
Fusioneren	Fusioneerde	Gefusioneerd
Futselen	Futselde	Gefutseld
Fêteren	Fêteerde	Gefêteerd
Gaffelen	Gaffelde	Gegaffeld
Gaggelen	Gaggelde	Gegaggeld
Gakken	Gakte	Gegakt
Gallen	Galde	Gegald
Galonneren	Galonneerde	Gegalonneerd
Galopperen	Galoppeerde	Gegaloppeerd
Galvaniseren	Galvaniseerde	Gegalvaniseerd
Gamen	Gamede	Gegamed
Gangbangen	Gangbangde	Gegangbangd
Ganneven	Gannefde	Gegannefd
Ganzenborden	Ganzenbordde	Geganzenbord
Garen	Gaarde	Gegaard
Gareren	Gareerde	Gegareerd
Garven	Garfde	Gegarfd
Gassen	Gaste	Gegast
Gasteren	Gasteerde	Gegasteerd
Gaufreren	Gaufreerde	Gegaufreerd
Gebaren	Gebaarde	Gebaard
Gebieden	Gebood	Geboden
Gedenken		
Gedragen	Gedroeg	Gedragen
Gehengen	Gehengde	Gehengd
Gehoorzamen	Gehoorzaamde	Gehoorzaamd
Geilbekken	Geilbekte	Gegeilbekt
Geilen	Geilde	Gegeild
Geiten	Geitte	Gegeit
Gekken	Gekte	Gegekt
Gelen	Geelde	Gegeeld
Gelukken	Gelukte	Gelukt
Genaken	Genaakte	Genaakt
Generen	Geneerde	Gegeneerd
Genereren	Genereerde	Gegenereerd
Genezen	Genas	Genezen
Genoegen	Genoegde	Genoegd
Geren	Geerde	Gegeerd
Gerieven	Geriefde	Geriefd
Germaniseren	Germaniseerde	Gegermaniseerd
Gespen	Gespte	Gegespt
Getroosten	Getroostte	Getroost
Gevallen	Geviel	Gevallen
Gewagen	Gewaagde	Gewaagd
Gewinnen	Gewon	Gewonnen
Geworden	Gewerd	Geworden
Gidsen	Gidste	Gegidst
Giebelen	Giebelde	Gegiebeld
Giechelen	Giechelde	Gegiecheld
Giegagen	Giegaagde	Gegiegaagd
Gijlen	Gijlde	Gegijld
Gijpen	Gijpte	Gegijpt
Ginnegappen	Ginnegapte	Geginnegapt
Gipsen	Gipste	Gegipst
Gladden	Gladde	Geglad
Glarieogen	Glarieoogde	Geglarieoogd
Glariën	Glariede	Geglaried
Glasstralen	Glasstraalde	Geglasstraald
Glazuren	Glazuurde	Geglazuurd
Glimlachen	Glimlachte	Geglimlacht
Glissen	Gliste	Geglist
Glooien	Glooide	Geglooid
Gloren	Gloorde	Gegloord
Gloriëren	Glorieerde	Geglorieerd
Glosseren	Glosseerde	Geglosseerd
Glunderen	Glunderde	Geglunderd
Gluren	Gluurde	Gegluurd
Gluurogen	Gluuroogde	Gegluuroogd
Gniffelen	Gniffelde	Gegniffeld
Gnuiven	Gnuifde	Gegnuifd
Gokken	Gokte	Gegokt
Golfen	Golfte	Gegolft
Golven	Golfde	Gegolfd
Gommen	Gomde	Gegomd
Goochelen	Goochelde	Gegoocheld
Googelen	Googelde	Gegoogeld
Gordelen	Gordelde	Gegordeld
Gorden	Gordde	Gegord
Gourmetten	Gourmette	Gegourmet
Graaien	Graaide	Gegraaid
Grabbelen	Grabbelde	Gegrabbeld
Gradueren	Gradueerde	Gegradueerd
Granen	Graande	Gegraand
Granuleren	Granuleerde	Gegranuleerd
Grapjassen	Grapjaste	Gegrapjast
Grasduinen	Grasduinde	Gegrasduind
Gratificeren	Gratificeerde	Gegratificeerd
Gratiëren	Gratieerde	Gegratieerd
Grauwen	Grauwde	Gegrauwd
Graviteren	Graviteerde	Gegraviteerd
Greinen	Greinde	Gegreind
Greineren	Greineerde	Gegreineerd
Grenzen	Grensde	Gegrensd
Grienen	Griende	Gegriend
Griezelen	Griezelde	Gegriezeld
Griffelen	Griffelde	Gegriffeld
Grijnen	Grijnde	Gegrijnd
Grijnslachen	Grijnslachte	Gegrijnslacht
Grijnzen	Grijnsde	Gegrijnsd
Grijzen	Grijsde	Gegrijsd
Grimassen	Grimaste	Gegrimast
Grimlachen	Grimlachte	Gegrimlacht
Grimmen	Grimde	Gegrimd
Grinden	Grindde	Gegrind
Grinniken	Grinnikte	Gegrinnikt
Grinten	Grintte	Gegrint
Grissen	Griste	Gegrist
Groenen	Groende	Gegroend
Groepen	Groepte	Gegroept
Groeperen	Groepeerde	Gegroepeerd
Groeven	Groefde	Gegroefd
Grollen	Grolde	Gegrold
Grommelen	Grommelde	Gegrommeld
Grondverven	Grondverfde	Gegrondverfd
Grootspreken		
Grosseren	Grosseerde	Gegrosseerd
Grossieren	Grossierde	Gegrossierd
Gruizen	Gruisde	Gegruisd
Grutten	Grutte	Gegrut
Gruwelen	Gruwelde	Gegruweld
Guillocheren	Guillocheerde	Geguillocheerd
Guillotineren	Guillotineerde	Geguillotineerd
Gullen	Gulde	Geguld
Gulpen	Gulpte	Gegulpt
Gummen	Gumde	Gegumd
Gunnen	Gunde	Gegund
Gutsen	Gutste	Gegutst
Gymmen	Gymde	Gegymd
Haaien	Haaide	Gehaaid
Haarknippen		
Hacken	Hackte	Gehackt
Hagelen	Hagelde	Gehageld
Hagen	Haagde	Gehaagd
Haken	Haakte	Gehaakt
Hakketakken	Hakketakte	Gehakketakt
Hakketeren	Hakketeerde	Gehakketeerd
Hallucineren	Hallucineerde	Gehallucineerd
Halsteren	Halsterde	Gehalsterd
Halveren	Halveerde	Gehalveerd
Halvezolen	Halvezoolde	Gehalvezoold
Halzen	Halsde	Gehalsd
Hameren	Hamerde	Gehamerd
Hamsteren	Hamsterde	Gehamsterd
Handballen	Handbalde	Gehandbald
Handen	Handde	Gehand
Handgiften	Handgiftte	Gehandgift
Handhaven	Handhaafde	Gehandhaafd
Handicappen	Handicapte	Gehandicapt
Handwerken	Handwerkte	Gehandwerkt
Hangen	Hing	Gehangen
Hanggliden	Hangglidede	Gehangglided
Hannesen	Hanneste	Gehannest
Haperen	Haperde	Gehaperd
Harddraven	Harddraafde	Geharddraafd
Hardebollen	Hardebolde	Gehardebold
Hardrijden		
Haren	Haarde	Gehaard
Harmoniseren	Harmoniseerde	Geharmoniseerd
Harmoniëren	Harmonieerde	Geharmonieerd
Harnassen	Harnaste	Geharnast
Harpen	Harpte	Geharpt
Harpoeneren	Harpoeneerde	Geharpoeneerd
Harpuizen	Harpuisde	Geharpuisd
Harrewarren	Harrewarde	Geharreward
Haspelen	Haspelde	Gehaspeld
Hassebassen	Hassebaste	Gehassebast
Haten	Haatte	Gehaat
Headbangen	Headbangde	Geheadbangd
Headhunten	Headhuntte	Geheadhunt
Healen	Healde	Geheald
Heien	Heide	Geheid
Heiligen	Heiligde	Geheiligd
Heisteren	Heisterde	Geheisterd
Helleniseren	Helleniseerde	Gehelleniseerd
Hemelen	Hemelde	Gehemeld
Hemmen	Hemde	Gehemd
Hengelen	Hengelde	Gehengeld
Herademen	Herademde	Herademd
Herbeginnen	Herbegon	Herbegonnen
Herbeleggen	Herbelegde	Herbelegd
Herbeleven	Herbeleefde	Herbeleefd
Herbenoemen	Herbenoemde	Herbenoemd
Herbevestigen	Herbevestigde	Herbevestigd
Herbewapenen	Herbewapende	Herbewapend
Herbouwen	Herbouwde	Herbouwd
Herdefiniëren	Herdefinieerde	Geherdefinieerd
Herdoen	Herdeed	Herdaan
Herdopen	Herdoopte	Herdoopt
Herdrukken	Herdrukte	Herdrukt
Herenen	Hereende	Hereend
Herenigen	Herenigde	Herenigd
Herexamineren	Herexamineerde	Geherexamineerd
Herfinancieren	Herfinancierde	Geherfinancierd
Herformuleren	Herformuleerde	Geherformuleerd
Hergebruiken	Hergebruikte	Hergebruikt
Hergroeperen	Hergroepeerde	Gehergroepeerd
Herhuisvesten	Herhuisvestte	Geherhuisvest
Herijken	Herijkte	Herijkt
Herindelen	Herindeelde	Heringedeeld
Herinrichten	Herinrichtte	Heringericht
Herinterpreteren	Herinterpreteerde	Geherinterpreteerd
Herintreden	Herintrad	Heringetreden
Herintroduceren	Herintroduceerde	Geherintroduceerd
Herinvesteren	Herinvesteerde	Geherinvesteerd
Herkansen	Herkanste	Herkanst
Herkapitaliseren	Herkapitaliseerde	Geherkapitaliseerd
Herkauwen	Herkauwde	Herkauwd
Herkeuren	Herkeurde	Herkeurd
Herkiezen	Herkoos	Herkozen
Herkrijgen	Herkreeg	Herkregen
Herladen	Herlaadde	Herladen
Hermunten	Hermuntte	Hermunt
Hernieuwen	Hernieuwde	Hernieuwd
Heronderhandelen	Heronderhandelde	Heronderhandeld
Herontdekken	Herontdekte	Herontdekt
Herontginnen	Herontgon	Herontgonnen
Herontwerpen	Herontwierp	Herontworpen
Heropbouwen	Heropbouwde	Heropgebouwd
Heropenen	Heropende	Heropend
Heroprichten	Heroprichtte	Heropgericht
Heropvoeden	Heropvoedde	Heropgevoed
Herordenen	Herordende	Herordend
Heroriënteren	Heroriënteerde	Geheroriënteerd
Heroveren	Heroverde	Heroverd
Heroverwegen	Heroverwoog	Heroverwogen
Herpakken	Herpakte	Herpakt
Herplaatsen	Herplaatste	Herplaatst
Herrekenen	Herrekende	Herrekend
Herschatten	Herschatte	Herschat
Herschikken	Herschikte	Herschikt
Herscholen	Herschoolde	Herschoold
Herschrijven	Herschreef	Herschreven
Hersenspoelen	Hersenspoelde	Gehersenspoeld
Hersmeden	Hersmeedde	Hersmeed
Herspellen	Herspelde	Herspeld
Herstemmen	Herstemde	Herstemd
Herstructureren	Herstructureerde	Geherstructureerd
Hertalen	Hertaalde	Hertaald
Hertellen	Hertelde	Herteld
Hertrouwen	Hertrouwde	Hertrouwd
Heruitbrengen	Heruitbracht	Heruitgebracht
Heruitgeven	Heruitgaf	Heruitgegeven
Hervallen	Herviel	Hervallen
Herverdelen	Herverdeelde	Herverdeeld
Herverkavelen	Herverkavelde	Herverkaveld
Herverzekeren	Herverzekerde	Herverzekerd
Herwaarderen	Herwaardeerde	Geherwaardeerd
Herwerken	Herwerkte	Herwerkt
Heugen	Heugde	Geheugd
Heulen	Heulde	Geheuld
Heupwiegen	Heupwiegde	Geheupwiegd
Hevelen	Hevelde	Geheveld
Hielen	Hielde	Gehield
Hieuwen	Hieuwde	Gehieuwd
Hikken	Hikte	Gehikt
Hinkelen	Hinkelde	Gehinkeld
Hinkepinken	Hinkepinkte	Gehinkepinkt
Hinten	Hintte	Gehint
Hippelen	Hippelde	Gehippeld
Hippen	Hipte	Gehipt
Historiseren	Historiseerde	Gehistoriseerd
Hitsen	Hitste	Gehitst
Hobbyen	Hobbyde	Gehobbyd
Hockeyen	Hockeyde	Gehockeyd
Hoeken	Hoekte	Gehoekt
Hoepelen	Hoepelde	Gehoepeld
Hoeren	Hoerde	Gehoerd
Hoereren	Hoereerde	Gehoereerd
Hoesten	Hoestte	Gehoest
Hoetelen	Hoetelde	Gehoeteld
Hogen	Hoogde	Gehoogd
Hokken	Hokte	Gehokt
Holen	Hoolde	Gehoold
Homogeniseren	Homogeniseerde	Gehomogeniseerd
Homologeren	Homologeerde	Gehomologeerd
Hompelen	Hompelde	Gehompeld
Hongeren	Hongerde	Gehongerd
Honkballen	Honkbalde	Gehonkbald
Honken	Honkte	Gehonkt
Honoreren	Honoreerde	Gehonoreerd
Hooien	Hooide	Gehooid
Hopen	Hoopte	Gehoopt
Hoppen	Hopte	Gehopt
Hopsen	Hopste	Gehopst
Horden	Hordde	Gehord
Horten	Hortte	Gehort
Hospitaliseren	Hospitaliseerde	Gehospitaliseerd
Hospiteren	Hospiteerde	Gehospiteerd
Hossebossen	Hosseboste	Gehossebost
Hosselen	Hosselde	Gehosseld
Hossen	Hoste	Gehost
Hosten	Hostte	Gehost
Hotsen	Hotste	Gehotst
Hotten	Hotte	Gehot
Housen	Housede	Gehoused
Hoven	Hoofde	Gehoofd
Hovenieren	Hovenierde	Gehovenierd
Huichelen	Huichelde	Gehuicheld
Huidvetten	Huidvette	Gehuidvet
Huilebalken	Huilebalkte	Gehuilebalkt
Huiven	Huifde	Gehuifd
Hukken	Hukte	Gehukt
Humaniseren	Humaniseerde	Gehumaniseerd
Hummen	Humde	Gehumd
Huppelen	Huppelde	Gehuppeld
Huppen	Hupte	Gehupt
Hupsen	Hupste	Gehupst
Husselen	Husselde	Gehusseld
Hutselen	Hutselde	Gehutseld
Hutsen	Hutste	Gehutst
Hypen	Hypete	Gehypet
Hyperboliseren	Hyperboliseerde	Gehyperboliseerd
Hyperventileren	Hyperventileerde	Gehyperventileerd
Hypostaseren	Hypostaseerde	Gehypostaseerd
Hypothekeren	Hypothekeerde	Gehypothekeerd
I-bankieren	I-bankierde	Ge-i-bankierd
Iaën	Iade	Geïaad
Idealiseren	Idealiseerde	Geïdealiseerd
Ideologiseren	Ideologiseerde	Geïdeologiseerd
Ignoreren	Ignoreerde	Geïgnoreerd
Ijlen	Ijlde	Geijld
Ijsberen	Ijsbeerde	Geijsbeerd
Ijshockeyen	Ijshockeyde	Geijshockeyd
Ijsracen	Ijsracete	Geijsracet
Ijveren	Ijverde	Geijverd
Ijzelen	Ijzelde	Geijzeld
Ijzen	Ijsde	Geijsd
Imkeren	Imkerde	Geïmkerd
Immatriculeren	Immatriculeerde	Geïmmatriculeerd
Immigreren	Immigreerde	Geïmmigreerd
Immobiliseren	Immobiliseerde	Geïmmobiliseerd
Implanteren	Implanteerde	Geïmplanteerd
Implementeren	Implementeerde	Geïmplementeerd
Imploderen	Implodeerde	Geïmplodeerd
Impregneren	Impregneerde	Geïmpregneerd
Improviseren	Improviseerde	Geïmproviseerd
Inactiveren	Inactiveerde	Geïnactiveerd
Incasseren	Incasseerde	Geïncasseerd
Inclineren	Inclineerde	Geïnclineerd
Incorporeren	Incorporeerde	Geïncorporeerd
Indexeren	Indexeerde	Geïndexeerd
Indiceren	Indiceerde	Geïndiceerd
Individualiseren	Individualiseerde	Geïndividualiseerd
Indoctrineren	Indoctrineerde	Geïndoctrineerd
Indosseren	Indosseerde	Geïndosseerd
Induceren	Induceerde	Geïnduceerd
Industrialiseren	Industrialiseerde	Geïndustrialiseerd
Ineenpersen	Ineenpersde	Ineengepersd
Infantiliseren	Infantiliseerde	Geïnfantiliseerd
Infiltreren	Infiltreerde	Geïnfiltreerd
Influenceren	Influenceerde	Geïnfluenceerd
Informatiseren	Informatiseerde	Geïnformatiseerd
Inhaleren	Inhaleerde	Geïnhaleerd
Initialiseren	Initialiseerde	Geïnitialiseerd
Initiëren	Initieerde	Geïnitieerd
Inkten	Inktte	Geïnkt
Innoveren	Innoveerde	Geïnnoveerd
Insemineren	Insemineerde	Geïnsemineerd
Insinueren	Insinueerde	Geïnsinueerd
Insisteren	Insisteerde	Geïnsisteerd
Instigeren	Instigeerde	Geïnstigeerd
Institueren	Institueerde	Geïnstitueerd
Institutionaliseren	Institutionaliseerde	Geïnstitutionaliseerd
Instrumenteren	Instrumenteerde	Geïnstrumenteerd
Integreren	Integreerde	Geïntegreerd
Intenderen	Intendeerde	Geïntendeerd
Intensifiëren	Intensifieerde	Geïntensifieerd
Intensiveren	Intensiveerde	Geïntensiveerd
Intercepteren	Intercepteerde	Geïntercepteerd
Interliniëren	Interlinieerde	Geïnterlinieerd
Internaliseren	Internaliseerde	Geïnternaliseerd
Internationaliseren	Internationaliseerde	Geïnternationaliseerd
Internetbankieren	Internetbankierde	Geïnternetbankierd
Internetten	Internette	Geïnternet
Interpelleren	Interpelleerde	Geïnterpelleerd
Interpungeren	Interpungeerde	Geïnterpungeerd
Interviewen	Interviewde	Geïnterviewd
Intoneren	Intoneerde	Geïntoneerd
Introduceren	Introduceerde	Geïntroduceerd
Inunderen	Inundeerde	Geïnundeerd
Invalideren	Invalideerde	Geïnvalideerd
Inventariseren	Inventariseerde	Geïnventariseerd
Involveren	Involveerde	Geïnvolveerd
Ioniseren	Ioniseerde	Geïoniseerd
Ironiseren	Ironiseerde	Geïroniseerd
Islamiseren	Islamiseerde	Geïslamiseerd
Isomeriseren	Isomeriseerde	Geïsomeriseerd
Italianiseren	Italianiseerde	Geïtalianiseerd
Itereren	Itereerde	Geïtereerd
Jakhalzen	Jakhalsde	Gejakhalsd
Jakkeren	Jakkerde	Gejakkerd
Jalonneren	Jalonneerde	Gejalonneerd
Jammen	Jamde	Gejamd
Jammeren	Jammerde	Gejammerd
Janken	Jankte	Gejankt
Japen	Jaapte	Gejaapt
Jatten	Jatte	Gejat
Jeinen	Jeinde	Gejeind
Jengelen	Jengelde	Gejengeld
Jennen	Jende	Gejend
Jeremiëren	Jeremieerde	Gejeremieerd
Jetskiën	Jetskiede	Gejetskied
Jeu-de-boulen	Jeu-de-boulde	Gejeu-de-bould
Jeuzelen	Jeuzelde	Gejeuzeld
Jijen	Jijde	Gejijd
Jobben	Jobde	Gejobd
Jobhoppen	Jobhopte	Gejobhopt
Jodelen	Jodelde	Gejodeld
Joechjachen	Joechjachte	Gejoechjacht
Joepen	Joepte	Gejoept
Joggelen	Joggelde	Gejoggeld
Joggen	Jogde	Gejogd
Joinen	Joinde	Gejoind
Jojoën	Jojode	Gejojood
Joken	Jookte	Gejookt
Jokeren	Jokerde	Gejokerd
Jokken	Jokte	Gejokt
Jolen	Joolde	Gejoold
Jollen	Jolde	Gejold
Jonassen	Jonaste	Gejonast
Jongen	Jongde	Gejongd
Jongleren	Jongleerde	Gejongleerd
Jonnen	Jonde	Gejond
Jouen	Joude	Gejoud
Jouwen	Jouwde	Gejouwd
Jubileren	Jubileerde	Gejubileerd
Judassen	Judaste	Gejudast
Judoën	Judode	Gejudood
Jufferen	Jufferde	Gejufferd
Jukken	Jukte	Gejukt
Jureren	Jureerde	Gejureerd
Justeren	Justeerde	Gejusteerd
Jutten	Jutte	Gejut
Kaaidraaien	Kaaidraaide	Gekaaidraaid
Kaaien	Kaaide	Gekaaid
Kaarten	Kaartte	Gekaart
Kaartlezen		
Kaatsen	Kaatste	Gekaatst
Kabelen	Kabelde	Gekabeld
Kadastreren	Kadastreerde	Gekadastreerd
Kaderen	Kaderde	Gekaderd
Kadraaien	Kadraaide	Gekadraaid
Kadreren	Kadreerde	Gekadreerd
Kafferen	Kafferde	Gekafferd
Kaften	Kaftte	Gekaft
Kaken	Kaakte	Gekaakt
Kalefaten	Kalefaatte	Gekalefaat
Kalen	Kaalde	Gekaald
Kalfaten	Kalfaatte	Gekalfaat
Kalken	Kalkte	Gekalkt
Kallegaaien	Kallegaaide	Gekallegaaid
Kallen	Kalde	Gekald
Kalligraferen	Kalligrafeerde	Gekalligrafeerd
Kalven	Kalfde	Gekalfd
Kalveren	Kalverde	Gekalverd
Kamen	Kaamde	Gekaamd
Kamenieren	Kamenierde	Gekamenierd
Kanaliseren	Kanaliseerde	Gekanaliseerd
Kandelaren	Kandelaarde	Gekandelaard
Kandideren	Kandideerde	Gekandideerd
Kanen	Kaande	Gekaand
Kannibaliseren	Kannibaliseerde	Gekannibaliseerd
Kanonneren	Kanonneerde	Gekanonneerd
Kanoën	Kanode	Gekanood
Kanten	Kantte	Gekant
Kanthouwen	Kanthouwde	Gekanthouwd
Kantonneren	Kantonneerde	Gekantonneerd
Kantrechten	Kantrechtte	Gekantrecht
Kantwerken	Kantwerkte	Gekantwerkt
Kapen	Kaapte	Gekaapt
Kapitaliseren	Kapitaliseerde	Gekapitaliseerd
Kapittelen	Kapittelde	Gekapitteld
Kapseizen	Kapseisde	Gekapseisd
Karaoken	Karaookte	Gekaraookt
Karikaturiseren	Karikaturiseerde	Gekarikaturiseerd
Karnen	Karnde	Gekarnd
Karnoffelen	Karnoffelde	Gekarnoffeld
Kartelen	Kartelde	Gekarteld
Karten	Kartte	Gekart
Karteren	Karteerde	Gekarteerd
Kartonneren	Kartonneerde	Gekartonneerd
Karweien	Karweide	Gekarweid
Kasjeren	Kasjerde	Gekasjerd
Kasseien	Kasseide	Gekasseid
Kassen	Kaste	Gekast
Katalyseren	Katalyseerde	Gekatalyseerd
Katapulteren	Katapulteerde	Gekatapulteerd
Kathalzen	Kathalsde	Gekathalsd
Katheteriseren	Katheteriseerde	Gekatheteriseerd
Katten	Katte	Gekat
Kauwen	Kauwde	Gekauwd
Kavelen	Kavelde	Gekaveld
Kazen	Kaasde	Gekaasd
Kazerneren	Kazerneerde	Gekazerneerd
Keepen	Keepte	Gekeept
Keesten	Keestte	Gekeest
Keffen	Kefte	Gekeft
Kegelen	Kegelde	Gekegeld
Kelderen	Kelderde	Gekelderd
Kelen	Keelde	Gekeeld
Kenen	Keende	Gekeend
Kenschetsen	Kenschetste	Gekenschetst
Kentekenen	Kentekende	Gekentekend
Kepen	Keepte	Gekeept
Keperen	Keperde	Gekeperd
Kerken	Kerkte	Gekerkt
Kerkeren	Kerkerde	Gekerkerd
Kermissen	Kermiste	Gekermist
Kerstenen	Kerstende	Gekerstend
Keten	Keette	Gekeet
Ketenen	Ketende	Geketend
Ketsen	Ketste	Geketst
Keuen	Keude	Gekeud
Keutelen	Keutelde	Gekeuteld
Keuteren	Keuterde	Gekeuterd
Keveren	Keverde	Gekeverd
Kezen	Keesde	Gekeesd
Kibbelen	Kibbelde	Gekibbeld
Kickboksen	Kickbokste	Gekickbokst
Kicken	Kickte	Gekickt
Kidnappen	Kidnapte	Gekidnapt
Kielen	Kielde	Gekield
Kielhalen	Kielhaalde	Gekielhaald
Kiemen	Kiemde	Gekiemd
Kienen	Kiende	Gekiend
Kiepen	Kiepte	Gekiept
Kieperen	Kieperde	Gekieperd
Kieren	Kierde	Gekierd
Kieskauwen	Kieskauwde	Gekieskauwd
Kikhalzen	Kikhalsde	Gekikhalsd
Kikken	Kikte	Gekikt
Kikkeren	Kikkerde	Gekikkerd
Killen	Kilde	Gekild
Kimmen	Kimde	Gekimd
Kinkelen	Kinkelde	Gekinkeld
Kippen	Kipte	Gekipt
Kiskassen	Kiskaste	Gekiskast
Kissebissen	Kissebiste	Gekissebist
Kissen	Kiste	Gekist
Kisten	Kistte	Gekist
Kiteboarden	Kiteboardde	Gekiteboard
Kiteskaten	Kiteskatete	Gekiteskatet
Kitesurfen	Kitesurfte	Gekitesurft
Kitsen	Kitste	Gekitst
Kitten	Kitte	Gekit
Klabetteren	Klabetterde	Geklabetterd
Kladderen	Kladderde	Gekladderd
Kladschilderen	Kladschilderde	Gekladschilderd
Klagen	Klaagde	Geklaagd
Klamaaien	Klamaaide	Geklamaaid
Klampen	Klampte	Geklampt
Klappeien	Klappeide	Geklappeid
Klappertanden	Klappertandde	Geklappertand
Klapwieken	Klapwiekte	Geklapwiekt
Klasseren	Klasseerde	Geklasseerd
Klaverjassen	Klaverjaste	Geklaverjast
Kledderen	Kledderde	Gekledderd
Kleien	Kleide	Gekleid
Kleineren	Kleineerde	Gekleineerd
Kleinzen	Kleinsde	Gekleinsd
Klepelen	Klepelde	Geklepeld
Klessebessen	Klessebeste	Geklessebest
Kleumen	Kleumde	Gekleumd
Kleunen	Kleunde	Gekleund
Kleuteren	Kleuterde	Gekleuterd
Kleven	Kleefde	Gekleefd
Kliederen	Kliederde	Gekliederd
Klieken	Kliekte	Gekliekt
Klieren	Klierde	Geklierd
Klikklakken	Klikklakte	Geklikklakt
Klissen	Kliste	Geklist
Klisteren	Klisteerde	Geklisteerd
Klitten	Klitte	Geklit
Klodderen	Klodderde	Geklodderd
Kloeten	Kloette	Gekloet
Klonen	Kloonde	Gekloond
Kloneren	Kloneerde	Gekloneerd
Klonteren	Klonterde	Geklonterd
Klooien	Klooide	Geklooid
Klossen	Kloste	Geklost
Kloten	Klootte	Gekloot
Kluisteren	Kluisterde	Gekluisterd
Kluiven	Kloof	Gekloven
Kluizen	Kluisde	Gekluisd
Klunen	Kluunde	Gekluund
Klungelen	Klungelde	Geklungeld
Klunzen	Klunsde	Geklunsd
Kluppelen	Kluppelde	Gekluppeld
Klussen	Kluste	Geklust
Klutsen	Klutste	Geklutst
Knabbelen	Knabbelde	Geknabbeld
Knagen	Knaagde	Geknaagd
Knakken	Knakte	Geknakt
Knarpen	Knarpte	Geknarpt
Knarsetanden	Knarsetandde	Geknarsetand
Knerpen	Knerpte	Geknerpt
Kneukelen	Kneukelde	Gekneukeld
Kneuteren	Kneuterde	Gekneuterd
Knibbelen	Knibbelde	Geknibbeld
Kniebanden	Kniebandde	Geknieband
Kniepoten	Kniepootte	Gekniepoot
Kniezen	Kniesde	Gekniesd
Knikkebenen	Knikkebeende	Geknikkebeend
Knikkebollen	Knikkebolde	Geknikkebold
Knikken	Knikte	Geknikt
Knikkeren	Knikkerde	Geknikkerd
Knisperen	Knisperde	Geknisperd
Knisteren	Knisterde	Geknisterd
Knobbelen	Knobbelde	Geknobbeld
Knobelen	Knobelde	Geknobeld
Knokken	Knokte	Geknokt
Knoppen	Knopte	Geknopt
Knotten	Knotte	Geknot
Knuffelen	Knuffelde	Geknuffeld
Knuppelen	Knuppelde	Geknuppeld
Knutselen	Knutselde	Geknutseld
Koeioneren	Koeioneerde	Gekoeioneerd
Koekeloeren	Koekeloerde	Gekoekeloerd
Koeken	Koekte	Gekoekt
Koeren	Koerde	Gekoerd
Koersen	Koerste	Gekoerst
Koeteren	Koeterde	Gekoeterd
Koeterwalen	Koeterwaalde	Gekoeterwaald
Koetsen	Koetste	Gekoetst
Kofferen	Kofferde	Gekofferd
Kogelen	Kogelde	Gekogeld
Kokhalzen	Kokhalsde	Gekokhalsd
Kokkelen	Kokkelde	Gekokkeld
Kokkerellen	Kokkerelde	Gekokkereld
Kokkeren	Kokkerde	Gekokkerd
Kolken	Kolkte	Gekolkt
Kollen	Kolde	Gekold
Kolonialiseren	Kolonialiseerde	Gekolonialiseerd
Koloniseren	Koloniseerde	Gekoloniseerd
Kolven	Kolfde	Gekolfd
Kondschappen	Kondschapte	Gekondschapt
Konkelfoezen	Konkelfoesde	Gekonkelfoesd
Konterfeiten	Konterfeitte	Gekonterfeit
Konvooieren	Konvooieerde	Gekonvooieerd
Kooien	Kooide	Gekooid
Koperen	Koperde	Gekoperd
Koppen	Kopte	Gekopt
Koprollen	Koprolde	Gekoprold
Korfballen	Korfbalde	Gekorfbald
Korrelen	Korrelde	Gekorreld
Korren	Korde	Gekord
Korsten	Korstte	Gekorst
Kortoren	Kortoorde	Gekortoord
Kortstaarten	Kortstaartte	Gekortstaart
Kortvleugelen	Kortvleugelde	Gekortvleugeld
Kortwieken	Kortwiekte	Gekortwiekt
Korven	Korfde	Gekorfd
Kosten	Kostte	Gekost
Kostumeren	Kostumeerde	Gekostumeerd
Koten	Kootte	Gekoot
Koteren	Koterde	Gekoterd
Kotteren	Kotterde	Gekotterd
Kouten	Koutte	Gekout
Kozen	Koosde	Gekoosd
Kraaien	Kraaide	Gekraaid
Krabbedieven	Krabbediefde	Gekrabbediefd
Krabbelen	Krabbelde	Gekrabbeld
Krachttrainen	Krachttrainde	Gekrachttraind
Krakken	Krakte	Gekrakt
Kralen	Kraalde	Gekraald
Kramen	Kraamde	Gekraamd
Krammen	Kramde	Gekramd
Kransen	Kranste	Gekranst
Krasselen	Krasselde	Gekrasseld
Krengen	Krengde	Gekrengd
Krenten	Krentte	Gekrent
Kreppen	Krepte	Gekrept
Kreupelen	Kreupelde	Gekreupeld
Krevelen	Krevelde	Gekreveld
Kribbelen	Kribbelde	Gekribbeld
Kribben	Kribde	Gekribd
Krieuwen	Krieuwde	Gekrieuwd
Krijzeltanden	Krijzeltandde	Gekrijzeltand
Krikken	Krikte	Gekrikt
Krikkrakken	Krikkrakte	Gekrikkrakt
Kringelen	Kringelde	Gekringeld
Krinkelen	Krinkelde	Gekrinkeld
Kriskrassen	Kriskraste	Gekriskrast
Krissen	Kriste	Gekrist
Kristalliseren	Kristalliseerde	Gekristalliseerd
Kroelen	Kroelde	Gekroeld
Kroezelen	Kroezelde	Gekroezeld
Kroezen	Kroesde	Gekroesd
Kroken	Krookte	Gekrookt
Krollen	Krolde	Gekrold
Kronometreren	Kronometreerde	Gekronometreerd
Kroppen	Kropte	Gekropt
Krozen	Kroosde	Gekroosd
Kruchen	Kruchte	Gekrucht
Kruidenieren	Kruidenierde	Gekruidenierd
Kruien	Kruide	Gekruid
Kruimen	Kruimde	Gekruimd
Kruipen	Kroop	Gekropen
Kruisjassen	Kruisjaste	Gekruisjast
Kruiven	Kruifde	Gekruifd
Krukken	Krukte	Gekrukt
Krullen	Krulde	Gekruld
Kuberen	Kubeerde	Gekubeerd
Kuchen	Kuchte	Gekucht
Kuipen	Kuipte	Gekuipt
Kuisen	Kuiste	Gekuist
Kuiven	Kuifde	Gekuifd
Kukelen	Kukelde	Gekukeld
Kullen	Kulde	Gekuld
Kunnen	Kon	Gekund
Kuren	Kuurde	Gekuurd
Kurken	Kurkte	Gekurkt
Kwadrateren	Kwadrateerde	Gekwadrateerd
Kwadreren	Kwadreerde	Gekwadreerd
Kwaken	Kwaakte	Gekwaakt
Kwakkelen	Kwakkelde	Gekwakkeld
Kwakken	Kwakte	Gekwakt
Kwakzalven	Kwakzalfde	Gekwakzalfd
Kwalificeren	Kwalificeerde	Gekwalificeerd
Kwalsteren	Kwalsterde	Gekwalsterd
Kwanselen	Kwanselde	Gekwanseld
Kwantificeren	Kwantificeerde	Gekwantificeerd
Kwartetten	Kwartette	Gekwartet
Kwebbelen	Kwebbelde	Gekwebbeld
Kwekken	Kwekte	Gekwekt
Kwelen	Kweelde	Gekweeld
Kwelmen	Kwelmde	Gekwelmd
Kwezelen	Kwezelde	Gekwezeld
Kwijlen	Kwijlde	Gekwijld
Kwijten	Kweet	Gekweten
Kwinkeleren	Kwinkeleerde	Gekwinkeleerd
Kwispelen	Kwispelde	Gekwispeld
Kwispelstaarten	Kwispelstaartte	Gekwispelstaart
Kwiteren	Kwiteerde	Gekwiteerd
Laaien	Laaide	Gelaaid
Labberen	Labberde	Gelabberd
Labelen	Labelde	Gelabeld
Labeuren	Labeurde	Gelabeurd
Laboreren	Laboreerde	Gelaboreerd
Lachen	Lachte	Gelachen
Ladderen	Ladderde	Geladderd
Laden	Laadde	Geladen
Lakken	Lakte	Gelakt
Lallen	Lalde	Gelald
Lambriseren	Lambriseerde	Gelambriseerd
Lamelleren	Lamelleerde	Gelamelleerd
Lamenteren	Lamenteerde	Gelamenteerd
Lamineren	Lamineerde	Gelamineerd
Lammeren	Lammerde	Gelammerd
Langen	Langde	Gelangd
Langlaufen	Langlaufte	Gelanglauft
Lanteren	Lanterde	Gelanterd
Lanterfanten	Lanterfantte	Gelanterfant
Lapzalven	Lapzalfde	Gelapzalfd
Laseren	Laserde	Gelaserd
Lasergamen	Lasergamede	Gelasergamed
Lassen	Laste	Gelast
Lasten	Lastte	Gelast
Lasteren	Lasterde	Gelasterd
Latiniseren	Latiniseerde	Gelatiniseerd
Latten	Latte	Gelat
Lauweren	Lauwerde	Gelauwerd
Laveren	Laveerde	Gelaveerd
Lawaaien	Lawaaide	Gelawaaid
Lay-outen	Lay-outte	Gelay-out
Lazeren	Lazerde	Gelazerd
Lazerstralen	Lazerstraalde	Gelazerstraald
Laïciseren	Laïciseerde	Gelaïciseerd
Leasen	Leasede	Geleased
Lebberen	Lebberde	Gelebberd
Leebraken	Leebraakte	Geleebraakt
Leerlooien		
Leewieken	Leewiekte	Geleewiekt
Leken	Leekte	Geleekt
Lekken	Lekte	Gelekt
Lekkerbekken	Lekkerbekte	Gelekkerbekt
Lellen	Lelde	Geleld
Lemen	Leemde	Geleemd
Lengen	Lengde	Gelengd
Lepelen	Lepelde	Gelepeld
Leppen	Lepte	Gelept
Lepperen	Lepperde	Gelepperd
Leraren	Leraarde	Geleraard
Lessen	Leste	Gelest
Letten	Lette	Gelet
Letteren	Letterde	Geletterd
Leuteren	Leuterde	Geleuterd
Leven	Leefde	Geleefd
Lezen	Las	Gelezen
Liberaliseren	Liberaliseerde	Geliberaliseerd
Lichtmissen	Lichtmiste	Gelichtmist
Liefhebberen	Liefhebberde	Geliefhebberd
Liegen	Loog	Gelogen
Liflaffen	Liflafte	Geliflaft
Lijnen	Lijnde	Gelijnd
Lijsten	Lijstte	Gelijst
Likkebaarden	Likkebaardde	Gelikkebaard
Likken	Likte	Gelikt
Lillen	Lilde	Gelild
Limiteren	Limiteerde	Gelimiteerd
Liniëren	Linieerde	Gelinieerd
Linken	Linkte	Gelinkt
Lippen	Lipte	Gelipt
Lispelen	Lispelde	Gelispeld
Lispen	Lispte	Gelispt
Lithograferen	Lithografeerde	Gelithografeerd
Liëren	Lieerde	Gelieerd
Lobberen	Lobberde	Gelobberd
Lobbyen	Lobbyde	Gelobbyd
Lodderen	Lodderde	Gelodderd
Lodderogen	Lodderoogde	Gelodderoogd
Loeren	Loerde	Geloerd
Loerogen	Loeroogde	Geloeroogd
Loeven	Loefde	Geloefd
Logenstraffen	Logenstrafte	Gelogenstraft
Loggen	Logde	Gelogd
Lokaliseren	Lokaliseerde	Gelokaliseerd
Lokken	Lokte	Gelokt
Lollen	Lolde	Gelold
Lonken	Lonkte	Gelonkt
Loodsen	Loodste	Geloodst
Lorren	Lorde	Gelord
Loten	Lootte	Geloot
Lozen	Loosde	Geloosd
Lubben	Lubde	Gelubd
Lubberen	Lubberde	Gelubberd
Luibakken	Luibakte	Geluibakt
Luien	Luide	Geluid
Luieren	Luierde	Geluierd
Luieriken	Luierikte	Geluierikt
Luiken	Look	Geloken
Luilakken	Luilakte	Geluilakt
Luimen	Luimde	Geluimd
Luistervinken	Luistervinkte	Geluistervinkt
Luiwammesen	Luiwammeste	Geluiwammest
Luizen	Luisde	Geluisd
Lukken	Lukte	Gelukt
Lullen	Lulde	Geluld
Lumbecken	Lumbeckte	Gelumbeckt
Lummelen	Lummelde	Gelummeld
Lunchen	Lunchte	Geluncht
Lunzen	Lunsde	Gelunsd
Lusten	Lustte	Gelust
Lynchen	Lynchte	Gelyncht
M-bankieren	M-bankierde	Ge-m-bankierd
Maaibenen	Maaibeende	Gemaaibeend
Maatslaan		
Macadamiseren	Macadamiseerde	Gemacadamiseerd
Macereren	Macereerde	Gemacereerd
Macrameeën	Macrameede	Gemacrameed
Magnetiseren	Magnetiseerde	Gemagnetiseerd
Mailen	Mailde	Gemaild
Mainteneren	Mainteneerde	Gemainteneerd
Majoreren	Majoreerde	Gemajoreerd
Makelen	Makelde	Gemakeld
Mallen	Malde	Gemald
Maltraiteren	Maltraiteerde	Gemaltraiteerd
Malverseren	Malverseerde	Gemalverseerd
Managen	Managede	Gemanaged
Mandateren	Mandateerde	Gemandateerd
Mandiën	Mandiede	Gemandied
Maneuvreren	Maneuvreerde	Gemaneuvreerd
Manicuren	Manicuurde	Gemanicuurd
Manken	Mankte	Gemankt
Mankeren	Mankeerde	Gemankeerd
Mannen	Mande	Gemand
Manumitteren	Manumitteerde	Gemanumitteerd
Marginaliseren	Marginaliseerde	Gemarginaliseerd
Markten	Marktte	Gemarkt
Marlen	Marlde	Gemarld
Marmelen	Marmelde	Gemarmeld
Maroderen	Marodeerde	Gemarodeerd
Marren	Marde	Gemard
Massacreren	Massacreerde	Gemassacreerd
Masseren	Masseerde	Gemasseerd
Massificeren	Massificeerde	Gemassificeerd
Masten	Mastte	Gemast
Mastieken	Mastiekte	Gemastiekt
Masturberen	Masturbeerde	Gemasturbeerd
Mathematiseren	Mathematiseerde	Gemathematiseerd
Matsen	Matste	Gematst
Matten	Matte	Gemat
Matteren	Matteerde	Gematteerd
Mauwen	Mauwde	Gemauwd
Maximaliseren	Maximaliseerde	Gemaximaliseerd
Maximeren	Maximeerde	Gemaximeerd
Mazelen	Mazelde	Gemazeld
Mazen	Maasde	Gemaasd
Mazzelen	Mazzelde	Gemazzeld
Meanderen	Meanderde	Gemeanderd
Mechaniseren	Mechaniseerde	Gemechaniseerd
Medicaliseren	Medicaliseerde	Gemedicaliseerd
Medicineren	Medicineerde	Gemedicineerd
Meerderen	Meerderde	Gemeerderd
Meesmuilen	Meesmuilde	Gemeesmuild
Meesteren	Meesterde	Gemeesterd
Meieren	Meierde	Gemeierd
Mekken	Mekte	Gemekt
Mekkeren	Mekkerde	Gemekkerd
Melen	Meelde	Gemeeld
Memoreren	Memoreerde	Gememoreerd
Memoriseren	Memoriseerde	Gememoriseerd
Menageren	Menageerde	Gemenageerd
Mendelen	Mendelde	Gemendeld
Meneren	Meneerde	Gemeneerd
Mengelen	Mengelde	Gemengeld
Meniën	Meniede	Gemenied
Mensendiecken	Mensendieckte	Gemensendieckt
Menstrueren	Menstrueerde	Gemenstrueerd
Merceriseren	Merceriseerde	Gemerceriseerd
Meren	Meerde	Gemeerd
Metalliseren	Metalliseerde	Gemetalliseerd
Metamorfoseren	Metamorfoseerde	Gemetamorfoseerd
Metastaseren	Metastaseerde	Gemetastaseerd
Metselen	Metselde	Gemetseld
Metsen	Metste	Gemetst
Meubelen	Meubelde	Gemeubeld
Meubileren	Meubileerde	Gemeubileerd
Meuken	Meukte	Gemeukt
Meuren	Meurde	Gemeurd
Mevrouwen	Mevrouwde	Gemevrouwd
Miauwen	Miauwde	Gemiauwd
Microfilmen	Microfilmde	Gemicrofilmd
Middagmalen	Middagmaalde	Gemiddagmaald
Middelen	Middelde	Gemiddeld
Midgetgolfen	Midgetgolfte	Gemidgetgolft
Miegelen	Miegelde	Gemiegeld
Miepen	Miepte	Gemiept
Mieren	Mierde	Gemierd
Mieteren	Mieterde	Gemieterd
Miezelen	Miezelde	Gemiezeld
Miezeren	Miezerde	Gemiezerd
Migreren	Migreerde	Gemigreerd
Mijmeren	Mijmerde	Gemijmerd
Mijnen	Mijnde	Gemijnd
Mijten	Mijtte	Gemijt
Mijteren	Mijterde	Gemijterd
Mikken	Mikte	Gemikt
Milderen	Milderde	Gemilderd
Militariseren	Militariseerde	Gemilitariseerd
Millimeteren	Millimeterde	Gemillimeterd
Mimen	Mimede	Gemimed
Minderen	Minderde	Geminderd
Mineraliseren	Mineraliseerde	Gemineraliseerd
Minimaliseren	Minimaliseerde	Geminimaliseerd
Miniseren	Miniseerde	Geminiseerd
Minnekozen	Minnekoosde	Geminnekoosd
Minnen	Minde	Gemind
Minoriseren	Minoriseerde	Geminoriseerd
Misachten	Misachtte	Misacht
Misbruiken	Misbruikte	Misbruikt
Misdoen	Misdeed	Misdaan
Misdragen	Misdroeg	Misdragen
Misdrijven	Misdreef	Misdreven
Misduiden	Misduidde	Misduid
Mis	Misging	Misgaan
Misgelden	Misgold	Misgolden
Mis	Misgreep	Misgrepen
Mishagen	Mishaagde	Mishaagd
Mishandelen	Mishandelde	Mishandeld
Mishoren	Mishoorde	Mishoord
Miskennen	Miskende	Miskend
Miskijken	Miskeek	Miskeken
Miskomen	Miskwam	Miskomen
Mislezen	Mislas	Mislezen
Mismeesteren	Mismeesterde	Mismeesterd
Misnoegen	Misnoegde	Misnoegd
Mispakken	Mispakte	Mispakt
Mispeuteren	Mispeuterde	Mispeuterd
Misprijzen	Misprees	Misprezen
Misrekenen	Misrekende	Misrekend
Missioneren	Missioneerde	Gemissioneerd
Misstaan	Misstond	Misstaan
Mistekenen	Mistekende	Mistekend
Misten	Mistte	Gemist
Mistrouwen	Mistrouwde	Mistrouwd
Misvallen	Misviel	Misvallen
Miszien	Miszag	Miszien
Mitigeren	Mitigeerde	Gemitigeerd
Mitrailleren	Mitrailleerde	Gemitrailleerd
Mitsen	Mitste	Gemitst
Mobiliseren	Mobiliseerde	Gemobiliseerd
Modereren	Modereerde	Gemodereerd
Moduleren	Moduleerde	Gemoduleerd
Moederen	Moederde	Gemoederd
Moeien	Moeide	Gemoeid
Moeren	Moerde	Gemoerd
Moffelen	Moffelde	Gemoffeld
Moireren	Moireerde	Gemoireerd
Mokeren	Mokerde	Gemokerd
Mokkelen	Mokkelde	Gemokkeld
Molesteren	Molesteerde	Gemolesteerd
Mollen	Molde	Gemold
Molmen	Molmde	Gemolmd
Mommelen	Mommelde	Gemommeld
Mommen	Momde	Gemomd
Monden	Mondde	Gemond
Monitoren	Monitorde	Gemonitord
Monkelen	Monkelde	Gemonkeld
Monken	Monkte	Gemonkt
Monoftongeren	Monoftongeerde	Gemonoftongeerd
Monopoliseren	Monopoliseerde	Gemonopoliseerd
Monopoliën	Monopoliede	Gemonopolied
Monopolyen	Monopolyde	Gemonopolyd
Montignaccen	Montignacte	Gemontignact
Moraliseren	Moraliseerde	Gemoraliseerd
Morrelen	Morrelde	Gemorreld
Morsen	Morste	Gemorst
Mortelen	Mortelde	Gemorteld
Morzelen	Morzelde	Gemorzeld
Motiveren	Motiveerde	Gemotiveerd
Motoriseren	Motoriseerde	Gemotoriseerd
Motorren	Motorde	Gemotord
Motregenen	Motregende	Gemotregend
Motsen	Motste	Gemotst
Motten	Motte	Gemot
Mountainbiken	Mountainbikete	Gemountainbiket
Mousseren	Mousseerde	Gemousseerd
Mouten	Moutte	Gemout
Moven	Movede	Gemoved
Moveren	Moveerde	Gemoveerd
Muffen	Mufte	Gemuft
Muggenziften	Muggenziftte	Gemuggenzift
Muiken	Muikte	Gemuikt
Muilbanden	Muilbandde	Gemuilband
Muilkorven	Muilkorfde	Gemuilkorfd
Muizen	Muisde	Gemuisd
Mummificeren	Mummificeerde	Gemummificeerd
Munten	Muntte	Gemunt
Murmureren	Murmureerde	Gemurmureerd
Murwen	Murwde	Gemurwd
Musiceren	Musiceerde	Gemusiceerd
Muteren	Muteerde	Gemuteerd
Mutileren	Mutileerde	Gemutileerd
Mystificeren	Mystificeerde	Gemystificeerd
Mythologiseren	Mythologiseerde	Gemythologiseerd
Mêleren	Mêleerde	Gemêleerd
Naaien	Naaide	Genaaid
Naasten	Naastte	Genaast
Nachtbraken	Nachtbraakte	Genachtbraakt
Naken	Naakte	Genaakt
Narren	Narde	Genard
Nasaleren	Nasaleerde	Genasaleerd
Nasjen	Nasjte	Genasjt
Nassen	Naste	Genast
Nationaliseren	Nationaliseerde	Genationaliseerd
Natten	Natte	Genat
Naturaliseren	Naturaliseerde	Genaturaliseerd
Navigeren	Navigeerde	Genavigeerd
Negligeren	Negligeerde	Genegligeerd
Negotiëren	Negotieerde	Genegotieerd
Nekken	Nekte	Genekt
Neppen	Nepte	Genept
Nestelen	Nestelde	Genesteld
Netelen	Netelde	Geneteld
Netten	Nette	Genet
Netwerken	Netwerkte	Genetwerkt
Neuken	Neukte	Geneukt
Neuriën	Neuriede	Geneuried
Neurotiseren	Neurotiseerde	Geneurotiseerd
Neutraliseren	Neutraliseerde	Geneutraliseerd
Neuzelen	Neuzelde	Geneuzeld
Neuzen	Neusde	Geneusd
Nevelen	Nevelde	Geneveld
Nieten	Niette	Geniet
Nijdassen	Nijdaste	Genijdast
Nikken	Nikte	Genikt
Niksen	Nikste	Genikst
Nippen	Nipte	Genipt
Nitreren	Nitreerde	Genitreerd
Nivelleren	Nivelleerde	Genivelleerd
Niëlleren	Niëlleerde	Geniëlleerd
Nodigen	Nodigde	Genodigd
Nokken	Nokte	Genokt
Nomineren	Nomineerde	Genomineerd
Noordelijken	Noordelijkte	Genoordelijkt
Noordoosteren	Noordoosterde	Genoordoosterd
Noordwesteren	Noordwesterde	Genoordwesterd
Nopen	Noopte	Genoopt
Noppen	Nopte	Genopt
Normaliseren	Normaliseerde	Genormaliseerd
Normeren	Normeerde	Genormeerd
Notificeren	Notificeerde	Genotificeerd
Nummeren	Nummerde	Genummerd
Nutten	Nutte	Genut
Objectiveren	Objectiveerde	Geobjectiveerd
Obstrueren	Obstrueerde	Geobstrueerd
Occuperen	Occupeerde	Geoccupeerd
Octrooieren	Octrooieerde	Geoctrooieerd
Odoriseren	Odoriseerde	Geodoriseerd
Officialiseren	Officialiseerde	Geofficialiseerd
Offreren	Offreerde	Geoffreerd
Ogen	Oogde	Geoogd
Ohaën	Ohade	Geohaad
Omberen	Omberde	Geomberd
Omcirkelen	Omcirkelde	Omcirkeld
Omdijken	Omdijkte	Omdijkt
Omfloersen	Omfloerste	Omfloerst
Om	Omgaf	Omgeven
Om	Omgordde	Omgord
Omgrenzen	Omgrensde	Omgrensd
Om	Omhing	Omhangen
Omheinen	Omheinde	Omheind
Omkaden	Omkaadde	Omkaad
Omkaderen	Omkaderde	Omkaderd
Omklemmen	Omklemde	Omklemd
Omknellen	Omknelde	Omkneld
Omkransen	Omkranste	Omkranst
Omlijnen	Omlijnde	Omlijnd
Omlijsten	Omlijstte	Omlijst
Ommuren	Ommuurde	Ommuurd
Omnevelen	Omnevelde	Omneveld
Ompalen	Ompaalde	Ompaald
Ompantseren	Ompantserde	Ompantserd
Omprangen	Omprangde	Omprangd
Omranden	Omrandde	Omrand
Omranken	Omrankte	Omrankt
Omrasteren	Omrasterde	Omrasterd
Omringen	Omringde	Omringd
Omschansen	Omschanste	Omschanst
Omsingelen	Omsingelde	Omsingeld
Om	Omslingerde	Omslingerd
Omsluiten	Omsloot	Omsloten
Omsnoeren	Omsnoerde	Omsnoerd
Om	Omspande	Omspannen
Omspelen	Omspeelde	Omspeeld
Omspinnen	Omspon	Omsponnen
Om	Omspoelde	Omspoeld
Omstikken	Omstikte	Omstikt
Omstralen	Omstraalde	Omstraald
Omstrengelen	Omstrengelde	Omstrengeld
Om	Omstuwde	Omstuwd
Omsuizen	Omsuisde	Omsuisd
Om	Omtrok	Omtrokken
Omtuinen	Omtuinde	Omtuind
Omvamen	Omvaamde	Omvaamd
Omvangen	Omving	Omvangen
Omwallen	Omwalde	Omwald
Omwalmen	Omwalmde	Omwalmd
Omweiden	Omweidde	Omweid
Om	Omwond	Omwonden
Om	Omwoelde	Omwoeld
Omwolken	Omwolkte	Omwolkt
Omzakken	Omzakte	Omzakt
Omzitten		
Omzwermen	Omzwermde	Omzwermd
Om	Omzweefde	Omzweefd
Omzwiepen	Omzwiepte	Omzwiept
Onaneren	Onaneerde	Geonaneerd
Onderbelichten	Onderbelichtte	Onderbelicht
Onderbenutten	Onderbenutte	Onderbenut
Onderbetalen	Onderbetaalde	Onderbetaald
Onderbevrachten	Onderbevrachtte	Onderbevracht
Onderblijven	Onderbleef	Onderbleven
Onderbouwen	Onderbouwde	Onderbouwd
Ondergieten	Ondergoot	Ondergoten
Onderhandelen	Onderhandelde	Onderhandeld
Onderkoelen	Onderkoelde	Onderkoeld
Onderkomen	Onderkwam	Onderkomen
Onderkopen	Onderkocht	Onderkocht
Onderkruipen	Onderkroop	Onderkropen
Onderleggen	Onderlegde	Onderlegd
Onderlijnen	Onderlijnde	Onderlijnd
Ondermengen	Ondermengde	Ondermengd
Ondernemen	Ondernam	Ondernomen
Onderrichten	Onderrichtte	Onderricht
Onderschatten	Onderschatte	Onderschat
Onderscheppen	Onderschepte	Onderschept
Onderschoren	Onderschoorde	Onderschoord
Onderschragen	Onderschraagde	Onderschraagd
Onderschrijden	Onderschreed	Onderschreden
Onderspannen	Onderspande	Onderspannen
Onderspoelen	Onderspoelde	Onderspoeld
Onder	Onderstond	Onderstaan
Onderstrepen	Onderstreepte	Onderstreept
Onderstuiven	Onderstoof	Onderstoven
Onderstutten	Onderstutte	Onderstut
Ondertitelen	Ondertitelde	Ondertiteld
Ondertrouwen	Ondertrouwde	Ondertrouwd
Ondertunnelen	Ondertunnelde	Ondertunneld
Ondervangen	Onderving	Ondervangen
Onderverdelen	Onderverdeelde	Onderverdeeld
Ondervoeden	Ondervoedde	Ondervoed
Onderwaarderen	Onderwaardeerde	Ondergewaardeerd
Onderzinken	Onderzonk	Onderzonken
Onduleren	Onduleerde	Geonduleerd
Ontadelen	Ontadelde	Ontadeld
Ontberen	Ontbeerde	Ontbeerd
Ontbieden	Ontbood	Ontboden
Ontbijten	Ontbeet	Ontbeten
Ontbladeren	Ontbladerde	Ontbladerd
Ontbloten	Ontblootte	Ontbloot
Ontboezemen	Ontboezemde	Ontboezemd
Ontbolsteren	Ontbolsterde	Ontbolsterd
Ontbossen	Ontboste	Ontbost
Ontcijferen	Ontcijferde	Ontcijferd
Ontdekken	Ontdekte	Ontdekt
Ontdoen	Ontdeed	Ontdaan
Ontdubbelen	Ontdubbelde	Ontdubbeld
Onteigenen	Onteigende	Onteigend
Onterven	Onterfde	Onterfd
Ontfermen	Ontfermde	Ontfermd
Ontfronsen	Ontfronste	Ontfronst
Ontfutselen	Ontfutselde	Ontfutseld
Ontgassen	Ontgaste	Ontgast
Ontgelden	Ontgold	Ontgolden
Ontgeven	Ontgaf	Ontgeven
Ontgiften	Ontgiftte	Ontgift
Ontginnen	Ontgon	Ontgonnen
Ontglijden	Ontgleed	Ontgleden
Ontglippen	Ontglipte	Ontglipt
Ontgloeien	Ontgloeide	Ontgloeid
Ontgoochelen	Ontgoochelde	Ontgoocheld
Ontgraten	Ontgraatte	Ontgraat
Ontgraven	Ontgroef	Ontgraven
Ontgrendelen	Ontgrendelde	Ontgrendeld
Ontgroeien	Ontgroeide	Ontgroeid
Ontgroenen	Ontgroende	Ontgroend
Ontgronden	Ontgrondde	Ontgrond
Onthaasten	Onthaastte	Onthaast
Onthalzen	Onthalsde	Onthalsd
Ontharden	Onthardde	Onthard
Ontharen	Onthaarde	Onthaard
Onthechten	Onthechtte	Onthecht
Ontheffen	Onthief	Ontheven
Ontinkten	Ontinktte	Ontinkt
Ontkalken	Ontkalkte	Ontkalkt
Ontkapen	Ontkaapte	Ontkaapt
Ontkerstenen	Ontkerstende	Ontkerstend
Ontkleuren	Ontkleurde	Ontkleurd
Ontknopen	Ontknoopte	Ontknoopt
Ontkolen	Ontkoolde	Ontkoold
Ontkoppelen	Ontkoppelde	Ontkoppeld
Ontkrachten	Ontkrachtte	Ontkracht
Ontkroezen	Ontkroesde	Ontkroesd
Ontlaten	Ontliet	Ontlaten
Ontleden	Ontleedde	Ontleed
Ontleren	Ontleerde	Ontleerd
Ontluchten	Ontluchtte	Ontlucht
Ontluizen	Ontluisde	Ontluisd
Ontmaken	Ontmaakte	Ontmaakt
Ontmantelen	Ontmantelde	Ontmanteld
Ontmaskeren	Ontmaskerde	Ontmaskerd
Ontmasten	Ontmastte	Ontmast
Ontmengen	Ontmengde	Ontmengd
Ontmenselijken	Ontmenselijkte	Ontmenselijkt
Ontmijnen	Ontmijnde	Ontmijnd
Ontmuggen	Ontmugde	Ontmugd
Ontmunten	Ontmuntte	Ontmunt
Ontmythologiseren	Ontmythologiseerde	Ontmythologiseerd
Ontnemen	Ontnam	Ontnomen
Ontnuchteren	Ontnuchterde	Ontnuchterd
Ontpachten	Ontpachtte	Ontpacht
Ontpakken	Ontpakte	Ontpakt
Ontpersen	Ontperste	Ontperst
Ontpoppen	Ontpopte	Ontpopt
Ontraadselen	Ontraadselde	Ontraadseld
Ontrafelen	Ontrafelde	Ontrafeld
Ontratten	Ontratte	Ontrat
Ontregelen	Ontregelde	Ontregeld
Ontroesten	Ontroestte	Ontroest
Ontroven	Ontroofde	Ontroofd
Ontrukken	Ontrukte	Ontrukt
Ontrusten	Ontrustte	Ontrust
Ontschepen	Ontscheepte	Ontscheept
Ontschieten	Ontschoot	Ontschoten
Ontschoeien	Ontschoeide	Ontschoeid
Ontschorsen	Ontschorste	Ontschorst
Ontsieren	Ontsierde	Ontsierd
Ontslaken	Ontslaakte	Ontslaakt
Ontslapen	Ontsliep	Ontslapen
Ontslippen	Ontslipte	Ontslipt
Ontsluieren	Ontsluierde	Ontsluierd
Ontsluimeren	Ontsluimerde	Ontsluimerd
Ontsluipen	Ontsloop	Ontslopen
Ontsluiten	Ontsloot	Ontsloten
Ontsparen	Ontspaarde	Ontspaard
Ontspiegelen	Ontspiegelde	Ontspiegeld
Ontspinnen	Ontspon	Ontsponnen
Ontstelen	Ontstal	Ontstolen
Ontstemmen	Ontstemde	Ontstemd
Ontstichten	Ontstichtte	Ontsticht
Ontstijgen	Ontsteeg	Ontstegen
Ontstoppen	Ontstopte	Ontstopt
Ontstoren	Ontstoorde	Ontstoord
Ontstrijden	Ontstreed	Ontstreden
Ontstrikken	Ontstrikte	Ontstrikt
Onttakelen	Onttakelde	Onttakeld
Onttoveren	Onttoverde	Onttoverd
Onttuigen	Onttuigde	Onttuigd
Ontvallen	Ontviel	Ontvallen
Ontvellen	Ontvelde	Ontveld
Ontvlechten	Ontvlocht	Ontvlochten
Ontvlekken	Ontvlekte	Ontvlekt
Ontvlezen	Ontvleesde	Ontvleesd
Ontvlieden	Ontvlood	Ontvloden
Ontvliegen	Ontvloog	Ontvlogen
Ontvloeien	Ontvloeide	Ontvloeid
Ontvlokken	Ontvlokte	Ontvlokt
Ontvolken	Ontvolkte	Ontvolkt
Ontvonken	Ontvonkte	Ontvonkt
Ontvrienden	Ontvriendde	Ontvriend
Ontvriezen	Ontvroor	Ontvroren
Ontwapenen	Ontwapende	Ontwapend
Ontwassen	Ontwies	Ontwassen
Ontwateren	Ontwaterde	Ontwaterd
Ontweien	Ontweide	Ontweid
Ontweldigen	Ontweldigde	Ontweldigd
Ontwellen	Ontwelde	Ontweld
Ontwennen	Ontwende	Ontwend
Ontwinden	Ontwond	Ontwonden
Ontwoekeren	Ontwoekerde	Ontwoekerd
Ontwormen	Ontwormde	Ontwormd
Ontworstelen	Ontworstelde	Ontworsteld
Ontwortelen	Ontwortelde	Ontworteld
Ontwringen	Ontwrong	Ontwrongen
Ontzadelen	Ontzadelde	Ontzadeld
Ontzegelen	Ontzegelde	Ontzegeld
Ontzeilen	Ontzeilde	Ontzeild
Ontzielen	Ontzielde	Ontzield
Ontzilten	Ontziltte	Ontzilt
Ontzinken	Ontzonk	Ontzonken
Ontzippen	Ontzipte	Ontzipt
Ontzouten	Ontzoutte	Ontzouten
Ontzuilen	Ontzuilde	Ontzuild
Ontzuren	Ontzuurde	Ontzuurd
Ontzwachtelen	Ontzwachtelde	Ontzwachteld
Ontzwavelen	Ontzwavelde	Ontzwaveld
Ontzwellen	Ontzwol	Ontzwollen
Onweren	Onweerde	Geonweerd
Oorlogen	Oorloogde	Geoorloogd
Oormerken	Oormerkte	Geoormerkt
Operationaliseren	Operationaliseerde	Geoperationaliseerd
Opereren	Opereerde	Geopereerd
Opiniëren	Opinieerde	Geopinieerd
Opstuiten		
Optimaliseren	Optimaliseerde	Geoptimaliseerd
Orakelen	Orakelde	Georakeld
Ordineren	Ordineerde	Geordineerd
Ordonneren	Ordonneerde	Geordonneerd
Oreren	Oreerde	Georeerd
Orgelen	Orgelde	Georgeld
Orkestreren	Orkestreerde	Georkestreerd
Ornamenteren	Ornamenteerde	Geornamenteerd
Otteren	Otterde	Geotterd
Outilleren	Outilleerde	Geoutilleerd
Ouwehoeren	Ouwehoerde	Geouwehoerd
Ouwenelen	Ouweneelde	Geouweneeld
Overbelasten	Overbelastte	Overbelast
Overbelichten	Overbelichtte	Overbelicht
Overbevolken	Overbevolkte	Overbevolkt
Overbieden	Overbood	Overboden
Overbluffen	Overblufte	Overbluft
Overbruggen	Overbrugde	Overbrugd
Overcompenseren	Overcompenseerde	Overgecompenseerd
Overdekken	Overdekte	Overdekt
Overdonderen	Overdonderde	Overdonderd
Overduvelen	Overduvelde	Overduveld
Overeten	Overat	Overeten
Overgroeien	Overgroeide	Overgroeid
Overhaasten	Overhaastte	Overhaast
Overhoren	Overhoorde	Overhoord
Overhuiven	Overhuifde	Overhuifd
Overijlen	Overijlde	Overijld
Overkappen	Overkapte	Overkapt
Over	Overkeek	Overkeken
Overklassen	Overklaste	Overklast
Overkluizen	Overkluisde	Overkluisd
Overkoepelen	Overkoepelde	Overkoepeld
Overkroppen	Overkropte	Overkropt
Overlappen	Overlapte	Overlapt
Overlasten	Overlastte	Overlast
Overleven	Overleefde	Overleefd
Overlommeren	Overlommerde	Overlommerd
Overmannen	Overmande	Overmand
Overmeesteren	Overmeesterde	Overmeesterd
Overnachten	Overnachtte	Overnacht
Overpeinzen	Overpeinsde	Overpeinsd
Over	Overpraatte	Overpraat
Overprikkelen	Overprikkelde	Overprikkeld
Overreageren	Overreageerde	Overreageerd
Overroepen	Overriep	Overroepen
Overrompelen	Overrompelde	Overrompeld
Overrulen	Overrulede	Overruled
Overschaduwen	Overschaduwde	Overschaduwd
Over	Overschatte	Overschat
Over	Overschilderde	Overschilderd
Overschitteren	Overschitterde	Overschitterd
Overschouwen	Overschouwde	Overschouwd
Overschreeuwen	Overschreeuwde	Overschreeuwd
Overschrijden	Overschreed	Overschreden
Overslapen	Oversliep	Overslapen
Overspannen	Overspande	Overspannen
Over	Overspeelde	Overspeeld
Overspoelen	Overspoelde	Overspoeld
Over	Overspoot	Overspoten
Overstaan	Overstond	Overstaan
Over	Overstemde	Overstemd
Overstijgen	Oversteeg	Overstegen
Overstralen	Overstraalde	Overstraald
Over	Overtekende	Overtekend
Overtijgen	Overtoog	Overtogen
Over	Overtrad	Overtreden
Overtroeven	Overtroefde	Overtroefd
Over	Overvoer	Overvaren
Oververhitten	Oververhitte	Oververhit
Oververmoeien	Oververmoeide	Oververmoeid
Oververzadigen	Oververzadigde	Oververzadigd
Overvleugelen	Overvleugelde	Overvleugeld
Overvoeden	Overvoedde	Overvoed
Over	Overvoerde	Overvoerd
Overwelven	Overwelfde	Overwelfd
Over	Overwerkte	Overwerkt
Overwinteren	Overwinterde	Overwinterd
Overwoekeren	Overwoekerde	Overwoekerd
Over	Overzeilde	Overzeild
Over	Overzag	Overzien
Ovuleren	Ovuleerde	Geovuleerd
Ozoniseren	Ozoniseerde	Geozoniseerd
Paaldansen	Paaldanste	Gepaaldanst
Pacen	Pacete	Gepacet
Pachten	Pachtte	Gepacht
Pacteren	Pacteerde	Gepacteerd
Paddelen	Paddelde	Gepaddeld
Pagaaien	Pagaaide	Gepagaaid
Pagineren	Pagineerde	Gepagineerd
Paintballen	Paintballde	Gepaintballd
Palaveren	Palaverde	Gepalaverd
Palen	Paalde	Gepaald
Paleren	Paleerde	Gepaleerd
Paletten	Palette	Gepalet
Palissaderen	Palissadeerde	Gepalissadeerd
Palmen	Palmde	Gepalmd
Palperen	Palpeerde	Gepalpeerd
Palpiteren	Palpiteerde	Gepalpiteerd
Pamperen	Pamperde	Gepamperd
Panacheren	Panacheerde	Gepanacheerd
Panden	Pandde	Gepand
Pandoeren	Pandoerde	Gepandoerd
Panikeren	Panikeerde	Gepanikeerd
Panlikken	Panlikte	Gepanlikt
Parachuteren	Parachuteerde	Geparachuteerd
Paraferen	Parafeerde	Geparafeerd
Paraffineren	Paraffineerde	Geparaffineerd
Parafraseren	Parafraseerde	Geparafraseerd
Paragraferen	Paragrafeerde	Geparagrafeerd
Paralyseren	Paralyseerde	Geparalyseerd
Parasiteren	Parasiteerde	Geparasiteerd
Pardonneren	Pardonneerde	Gepardonneerd
Parelen	Parelde	Gepareld
Paren	Paarde	Gepaard
Parfumeren	Parfumeerde	Geparfumeerd
Parkeren	Parkeerde	Geparkeerd
Parketteren	Parketteerde	Geparketteerd
Parlementen	Parlementte	Geparlement
Parlementeren	Parlementeerde	Geparlementeerd
Parlesanten	Parlesantte	Geparlesant
Parlevinken	Parlevinkte	Geparlevinkt
Parsen	Parsete	Geparset
Participeren	Participeerde	Geparticipeerd
Partyen	Partyde	Gepartyd
Pasporteren	Pasporteerde	Gepasporteerd
Passagieren	Passagierde	Gepassagierd
Pasteuriseren	Pasteuriseerde	Gepasteuriseerd
Patenteren	Patenteerde	Gepatenteerd
Paternosteren	Paternosterde	Gepaternosterd
Patineren	Patineerde	Gepatineerd
Patroneren	Patroneerde	Gepatroneerd
Patroniseren	Patroniseerde	Gepatroniseerd
Patrouilleren	Patrouilleerde	Gepatrouilleerd
Patsen	Patste	Gepatst
Pauken	Paukte	Gepaukt
Pauzeren	Pauzeerde	Gepauzeerd
Pavoiseren	Pavoiseerde	Gepavoiseerd
Pedicuren	Pedicuurde	Gepedicuurd
Pegelen	Pegelde	Gepegeld
Peigeren	Peigerde	Gepeigerd
Pekken	Pekte	Gepekt
Pelen	Peelde	Gepeeld
Pelgrimeren	Pelgrimeerde	Gepelgrimeerd
Penaliseren	Penaliseerde	Gepenaliseerd
Pendelen	Pendelde	Gependeld
Penetreren	Penetreerde	Gepenetreerd
Pennen	Pende	Gepend
Penselen	Penseelde	Gepenseeld
Pensioneren	Pensioneerde	Gepensioneerd
Peperen	Peperde	Gepeperd
Percipiëren	Percipieerde	Gepercipieerd
Percuteren	Percuteerde	Gepercuteerd
Peren	Peerde	Gepeerd
Perfectioneren	Perfectioneerde	Geperfectioneerd
Perforeren	Perforeerde	Geperforeerd
Periodiseren	Periodiseerde	Geperiodiseerd
Perken	Perkte	Geperkt
Permanenten	Permanentte	Gepermanent
Peroreren	Peroreerde	Geperoreerd
Perpendiculariseren	Perpendiculariseerde	Geperpendiculariseerd
Persevereren	Persevereerde	Gepersevereerd
Persifleren	Persifleerde	Gepersifleerd
Persisteren	Persisteerde	Gepersisteerd
Personifiëren	Personifieerde	Gepersonifieerd
Perverteren	Perverteerde	Geperverteerd
Pesten	Pestte	Gepest
Petanquen	Petanquete	Gepetanquet
Petitioneren	Petitioneerde	Gepetitioneerd
Petsen	Petste	Gepetst
Peuren	Peurde	Gepeurd
Peuteren	Peuterde	Gepeuterd
Peuzelen	Peuzelde	Gepeuzeld
Pezen	Peesde	Gepeesd
Pezeweven	Pezeweefde	Gepezeweefd
Picknicken	Picknickte	Gepicknickt
Piefpaffen	Piefpafte	Gepiefpaft
Pieken	Piekte	Gepiekt
Pielen	Pielde	Gepield
Piemelen	Piemelde	Gepiemeld
Piepelen	Piepelde	Gepiepeld
Piercen	Piercete	Gepiercet
Pieren	Pierde	Gepierd
Pierewaaien	Pierewaaide	Gepierewaaid
Pietepeuteren	Pietepeuterde	Gepietepeuterd
Pifpaffen	Pifpafte	Gepifpaft
Pijnen	Pijnde	Gepijnd
Pijpen	Pijpte	Gepijpt
Piketten	Pikette	Gepiket
Piketteren	Piketteerde	Gepiketteerd
Pikkelen	Pikkelde	Gepikkeld
Pillen	Pilde	Gepild
Pimpampetten	Pimpampette	Gepimpampet
Pimpelen	Pimpelde	Gepimpeld
Pinaren	Pinaarde	Gepinaard
Pingpongen	Pingpongde	Gepingpongd
Pinkelen	Pinkelde	Gepinkeld
Pinkeren	Pinkerde	Gepinkerd
Pinkogen	Pinkoogde	Gepinkoogd
Pinnen	Pinde	Gepind
Pintelieren	Pintelierde	Gepintelierd
Pionieren	Pionierde	Gepionierd
Pipetteren	Pipetteerde	Gepipetteerd
Pirouetteren	Pirouetteerde	Gepirouetteerd
Pitchen	Pitchte	Gepitcht
Pitsen	Pitste	Gepitst
Plaasteren	Plaasterde	Geplaasterd
Plafonneren	Plafonneerde	Geplafonneerd
Plagen	Plaagde	Geplaagd
Plaggen	Plagde	Geplagd
Plagiëren	Plagieerde	Geplagieerd
Plamuren	Plamuurde	Geplamuurd
Planeren	Planeerde	Geplaneerd
Planteren	Planteerde	Geplanteerd
Plasregenen	Plasregende	Geplasregend
Plastificeren	Plastificeerde	Geplastificeerd
Plateren	Plateerde	Geplateerd
Platineren	Platineerde	Geplatineerd
Platten	Platte	Geplat
Platvoeten	Platvoette	Geplatvoet
Playbacken	Playbackte	Geplaybackt
Pleiten	Pleitte	Gepleit
Plekken	Plekte	Geplekt
Plempen	Plempte	Geplempt
Plensregenen	Plensregende	Geplensregend
Plenzen	Plensde	Geplensd
Pletsen	Pletste	Gepletst
Pletten	Plette	Geplet
Pletteren	Pletterde	Gepletterd
Pleuren	Pleurde	Gepleurd
Plezieren	Plezierde	Geplezierd
Plisseren	Plisseerde	Geplisseerd
Ploffen	Plofte	Geploft
Plompen	Plompte	Geplompt
Ploten	Plootte	Geploot
Plotten	Plotte	Geplot
Pluggen	Plugde	Geplugd
Pluimen	Pluimde	Gepluimd
Pluimstrijken	Pluimstrijkte	Gepluimstrijkt
Pluizen	Pluisde	Gepluisd
Pluizen	Ploos	Geplozen
Plukharen	Plukhaarde	Geplukhaard
Plussen	Pluste	Geplust
Pocheren	Pocheerde	Gepocheerd
Poedelen	Poedelde	Gepoedeld
Poederen	Poederde	Gepoederd
Poeieren	Poeierde	Gepoeierd
Poeren	Poerde	Gepoerd
Poffen	Pofte	Gepoft
Pogoën	Pogode	Gepogood
Pointeren	Pointeerde	Gepointeerd
Pointilleren	Pointilleerde	Gepointilleerd
Poken	Pookte	Gepookt
Pokeren	Pokerde	Gepokerd
Pokken	Pokte	Gepokt
Polariseren	Polariseerde	Gepolariseerd
Polemiseren	Polemiseerde	Gepolemiseerd
Polieren	Polierde	Gepolierd
Politiseren	Politiseerde	Gepolitiseerd
Politoeren	Politoerde	Gepolitoerd
Poloën	Polode	Gepolood
Polsstokspringen		
Polychromeren	Polychromeerde	Gepolychromeerd
Polymeriseren	Polymeriseerde	Gepolymeriseerd
Pommaderen	Pommadeerde	Gepommadeerd
Poneren	Poneerde	Geponeerd
Pontificeren	Pontificeerde	Gepontificeerd
Pooien	Pooide	Gepooid
Poolen	Poolde	Gepoold
Popelen	Popelde	Gepopeld
Populariseren	Populariseerde	Gepopulariseerd
Porren	Porde	Gepord
Portelen	Portelde	Geporteld
Portretteren	Portretteerde	Geportretteerd
Positioneren	Positioneerde	Gepositioneerd
Postdateren	Postdateerde	Gepostdateerd
Posten	Postte	Gepost
Posteren	Posteerde	Geposteerd
Postuleren	Postuleerde	Gepostuleerd
Potloden	Potloodde	Gepotlood
Potten	Potte	Gepot
Potverteren	Potverteerde	Potverteerd
Pozen	Poosde	Gepoosd
Poëtiseren	Poëtiseerde	Gepoëtiseerd
Prachen	Prachte	Gepracht
Prakken	Prakte	Geprakt
Prakkezeren	Prakkezeerde	Geprakkezeerd
Prakkiseren	Prakkiseerde	Geprakkiseerd
Praktiseren	Praktiseerde	Gepraktiseerd
Pramen	Praamde	Gepraamd
Prangen	Prangde	Geprangd
Pratikeren	Pratikeerde	Gepratikeerd
Preadviseren	Preadviseerde	Gepreadviseerd
Precipiteren	Precipiteerde	Geprecipiteerd
Preciseren	Preciseerde	Gepreciseerd
Predestineren	Predestineerde	Gepredestineerd
Prediceren	Prediceerde	Geprediceerd
Predisponeren	Predisponeerde	Gepredisponeerd
Predomineren	Predomineerde	Gepredomineerd
Prefabriceren	Prefabriceerde	Geprefabriceerd
Prefigeren	Prefigeerde	Geprefigeerd
Preluderen	Preludeerde	Gepreludeerd
Premediteren	Premediteerde	Gepremediteerd
Prenten	Prentte	Geprent
Preoccuperen	Preoccupeerde	Gepreoccupeerd
Prepareren	Prepareerde	Geprepareerd
Preserveren	Preserveerde	Gepreserveerd
Presseren	Presseerde	Gepresseerd
Presteren	Presteerde	Gepresteerd
Presumeren	Presumeerde	Gepresumeerd
Pretenderen	Pretendeerde	Gepretendeerd
Preutelen	Preutelde	Gepreuteld
Priegelen	Priegelde	Gepriegeld
Primeren	Primeerde	Geprimeerd
Prioriteren	Prioriteerde	Geprioriteerd
Privatiseren	Privatiseerde	Geprivatiseerd
Privilegiëren	Privilegieerde	Geprivilegieerd
Problematiseren	Problematiseerde	Geproblematiseerd
Procederen	Procedeerde	Geprocedeerd
Producen	Producete	Geproducet
Professen	Profeste	Geprofest
Professionaliseren	Professionaliseerde	Geprofessionaliseerd
Profeteren	Profeteerde	Geprofeteerd
Profileren	Profileerde	Geprofileerd
Prognosticeren	Prognosticeerde	Geprognosticeerd
Projecteren	Projecteerde	Geprojecteerd
Proletariseren	Proletariseerde	Geproletariseerd
Prolongeren	Prolongeerde	Geprolongeerd
Promoten	Promootte	Gepromoot
Prononceren	Prononceerde	Geprononceerd
Pronostikeren	Pronostikeerde	Gepronostikeerd
Proosten	Proostte	Geproost
Propaganderen	Propagandeerde	Gepropagandeerd
Propageren	Propageerde	Gepropageerd
Proponeren	Proponeerde	Geproponeerd
Proppen	Propte	Gepropt
Prospecteren	Prospecteerde	Geprospecteerd
Prospereren	Prospereerde	Geprospereerd
Prostitueren	Prostitueerde	Geprostitueerd
Protegeren	Protegeerde	Geprotegeerd
Protocolleren	Protocolleerde	Geprotocolleerd
Protsen	Protste	Geprotst
Pruimen	Pruimde	Gepruimd
Prutsen	Prutste	Geprutst
Pruttelen	Pruttelde	Geprutteld
Psalmeren	Psalmeerde	Gepsalmeerd
Psalmodiëren	Psalmodieerde	Gepsalmodieerd
Psychologiseren	Psychologiseerde	Gepsychologiseerd
Puberen	Puberde	Gepuberd
Puddelen	Puddelde	Gepuddeld
Puffen	Pufte	Gepuft
Puilen	Puilde	Gepuild
Puimen	Puimde	Gepuimd
Pulken	Pulkte	Gepulkt
Pulsen	Pulste	Gepulst
Pulseren	Pulseerde	Gepulseerd
Pulveren	Pulverde	Gepulverd
Pulveriseren	Pulveriseerde	Gepulveriseerd
Puncteren	Puncteerde	Gepuncteerd
Punniken	Punnikte	Gepunnikt
Punten	Puntte	Gepunt
Punteren	Punteerde	Gepunteerd
Punteren	Punterde	Gepunterd
Puren	Puurde	Gepuurd
Pureren	Pureerde	Gepureerd
Purperen	Purperde	Gepurperd
Pushen	Pushte	Gepusht
Pussen	Puste	Gepust
Putsen	Putste	Geputst
Puzzelen	Puzzelde	Gepuzzeld
Quadrilleren	Quadrilleerde	Gequadrilleerd
Queruleren	Queruleerde	Gequeruleerd
Quoteren	Quoteerde	Gequoteerd
Quotiseren	Quotiseerde	Gequotiseerd
Raaien	Raaide	Geraaid
Rabatten	Rabatte	Gerabat
Rabatteren	Rabatteerde	Gerabatteerd
Rabbelen	Rabbelde	Gerabbeld
Racletten	Raclette	Geraclet
Radbraken	Radbraakte	Geradbraakt
Raderen	Radeerde	Geradeerd
Radicaliseren	Radicaliseerde	Geradicaliseerd
Radiograferen	Radiografeerde	Geradiografeerd
Rafelen	Rafelde	Gerafeld
Raffelen	Raffelde	Geraffeld
Ragen	Raagde	Geraagd
Raggen	Ragde	Geragd
Railleren	Railleerde	Gerailleerd
Raisonneren	Raisonneerde	Geraisonneerd
Rakelen	Rakelde	Gerakeld
Raketten	Rakette	Geraket
Rakkeren	Rakkerde	Gerakkerd
Rammeien	Rammeide	Gerammeid
Rammelen	Rammelde	Gerammeld
Rammen	Ramde	Geramd
Rampetampen	Rampetampte	Gerampetampt
Rampokken	Rampokte	Gerampokt
Ramsjen	Ramsjte	Geramsjt
Randen	Randde	Gerand
Ranken	Rankte	Gerankt
Ranselen	Ranselde	Geranseld
Rantsoeneren	Rantsoeneerde	Gerantsoeneerd
Rappelleren	Rappelleerde	Gerappelleerd
Rappen	Rapte	Gerapt
Rapporteren	Rapporteerde	Gerapporteerd
Raseren	Raseerde	Geraseerd
Raspen	Raspte	Geraspt
Rasteren	Rasterde	Gerasterd
Ratelen	Ratelde	Gerateld
Ratineren	Ratineerde	Geratineerd
Rationaliseren	Rationaliseerde	Gerationaliseerd
Ratsen	Ratste	Geratst
Ratten	Ratte	Gerat
Rauwdouwen	Rauwdouwde	Gerauwdouwd
Rauzen	Rausde	Gerausd
Ravotten	Ravotte	Geravot
Re-integreren	Re-integreerde	Gere-integreerd
Reactiveren	Reactiveerde	Gereactiveerd
Reaffecteren	Reaffecteerde	Gereaffecteerd
Reageren	Reageerde	Gereageerd
Reanimeren	Reanimeerde	Gereanimeerd
Reassureren	Reassureerde	Gereassureerd
Rebbelen	Rebbelde	Gerebbeld
Rebooten	Rebootte	Gereboot
Recapituleren	Recapituleerde	Gerecapituleerd
Recappen	Recapte	Gerecapt
Recepteren	Recepteerde	Gerecepteerd
Rechercheren	Rechercheerde	Gerechercheerd
Rechten	Rechtte	Gerecht
Rechtvaardigen	Rechtvaardigde	Gerechtvaardigd
Recidiveren	Recidiveerde	Gerecidiveerd
Recipiëren	Recipieerde	Gerecipieerd
Reciproceren	Reciproceerde	Gereciproceerd
Recirculeren	Recirculeerde	Gerecirculeerd
Reclameren	Reclameerde	Gereclameerd
Reclasseren	Reclasseerde	Gereclasseerd
Recombineren	Recombineerde	Gerecombineerd
Recreëren	Recreëerde	Gerecreëerd
Recupereren	Recupereerde	Gerecupereerd
Recyclen	Recyclede	Gerecycled
Recycleren	Recycleerde	Gerecycleerd
Redderen	Redderde	Geredderd
Redekavelen	Redekavelde	Geredekaveld
Reden	Reedde	Gereed
Redeneren	Redeneerde	Geredeneerd
Redevoeren	Redevoerde	Geredevoerd
Redoubleren	Redoubleerde	Geredoubleerd
Redresseren	Redresseerde	Geredresseerd
Reeuwen	Reeuwde	Gereeuwd
Refuseren	Refuseerde	Gerefuseerd
Regaleren	Regaleerde	Geregaleerd
Regarderen	Regardeerde	Geregardeerd
Regenereren	Regenereerde	Geregenereerd
Reggen	Regde	Geregd
Regionaliseren	Regionaliseerde	Geregionaliseerd
Regisseren	Regisseerde	Geregisseerd
Registeren	Registerde	Geregisterd
Reglementeren	Reglementeerde	Gereglementeerd
Regulariseren	Regulariseerde	Geregulariseerd
Rehabiliteren	Rehabiliteerde	Gerehabiliteerd
Reien	Reide	Gereid
Reiken	Reikte	Gereikt
Reilen	Reilde	Gereild
Reizen	Reisde	Gereisd
Rekestreren	Rekestreerde	Gerekestreerd
Rekruteren	Rekruteerde	Gerekruteerd
Rekwestreren	Rekwestreerde	Gerekwestreerd
Relateren	Relateerde	Gerelateerd
Relativeren	Relativeerde	Gerelativeerd
Relaxen	Relaxte	Gerelaxt
Relayeren	Relayeerde	Gerelayeerd
Releveren	Releveerde	Gereleveerd
Rellen	Relde	Gereld
Rembourseren	Rembourseerde	Gerembourseerd
Remediëren	Remedieerde	Geremedieerd
Remigreren	Remigreerde	Geremigreerd
Remiseren	Remiseerde	Geremiseerd
Remitteren	Remitteerde	Geremitteerd
Remixen	Remixte	Geremixt
Remonstreren	Remonstreerde	Geremonstreerd
Remplaceren	Remplaceerde	Geremplaceerd
Remunereren	Remunereerde	Geremunereerd
Renationaliseren	Renationaliseerde	Gerenationaliseerd
Renen	Reende	Gereend
Renonceren	Renonceerde	Gerenonceerd
Renormaliseren	Renormaliseerde	Gerenormaliseerd
Rentabiliseren	Rentabiliseerde	Gerentabiliseerd
Renten	Rentte	Gerent
Rentenieren	Rentenierde	Gerentenierd
Reorganiseren	Reorganiseerde	Gereorganiseerd
Repasseren	Repasseerde	Gerepasseerd
Repatriëren	Repatrieerde	Gerepatrieerd
Repelen	Repelde	Gerepeld
Repen	Reepte	Gereept
Repeteren	Repeteerde	Gerepeteerd
Reppen	Repte	Gerept
Representeren	Representeerde	Gerepresenteerd
Rescontreren	Rescontreerde	Gerescontreerd
Resetten	Resette	Gereset
Resigneren	Resigneerde	Geresigneerd
Resisteren	Resisteerde	Geresisteerd
Resocialiseren	Resocialiseerde	Geresocialiseerd
Resolveren	Resolveerde	Geresolveerd
Respireren	Respireerde	Gerespireerd
Responderen	Respondeerde	Gerespondeerd
Ressorteren	Ressorteerde	Geressorteerd
Restylen	Restylede	Gerestyled
Retarderen	Retardeerde	Geretardeerd
Retireren	Retireerde	Geretireerd
Retrograderen	Retrogradeerde	Geretrogradeerd
Reutelen	Reutelde	Gereuteld
Revaccineren	Revaccineerde	Gerevaccineerd
Revalideren	Revalideerde	Gerevalideerd
Revaloriseren	Revaloriseerde	Gerevaloriseerd
Revalueren	Revalueerde	Gerevalueerd
Revancheren	Revancheerde	Gerevancheerd
Reveleren	Reveleerde	Gereveleerd
Reven	Reefde	Gereefd
Revideren	Revideerde	Gerevideerd
Revieren	Revierde	Gerevierd
Revitaliseren	Revitaliseerde	Gerevitaliseerd
Revolteren	Revolteerde	Gerevolteerd
Revolutioneren	Revolutioneerde	Gerevolutioneerd
Reïncarneren	Reïncarneerde	Gereïncarneerd
Reüsseren	Reüsseerde	Gereüsseerd
Ribbelen	Ribbelde	Geribbeld
Ribben	Ribde	Geribd
Ridderen	Ridderde	Geridderd
Ridiculiseren	Ridiculiseerde	Geridiculiseerd
Riedelen	Riedelde	Geriedeld
Riemen	Riemde	Geriemd
Rijen	Rijde	Gerijd
Rijmelen	Rijmelde	Gerijmeld
Rijmen	Rijmde	Gerijmd
Rijpen	Rijpte	Gerijpt
Rijsttafelen	Rijsttafelde	Gerijsttafeld
Rijven	Reef	Gereven
Rikkekikken	Rikkekikte	Gerikkekikt
Rikken	Rikte	Gerikt
Rikketikken	Rikketikte	Gerikketikt
Rikkikken	Rikkikte	Gerikkikt
Ringelen	Ringelde	Geringeld
Ringeloren	Ringeloorde	Geringeloord
Ringen	Ringde	Geringd
Rinkelrooien	Rinkelrooide	Gerinkelrooid
Rinkinken	Rinkinkte	Gerinkinkt
Rioleren	Rioleerde	Gerioleerd
Riposteren	Riposteerde	Geriposteerd
Rippen	Ripte	Geript
Risken	Riskte	Geriskt
Risten	Ristte	Gerist
Ristorneren	Ristorneerde	Geristorneerd
Ritmeren	Ritmeerde	Geritmeerd
Ritten	Ritte	Gerit
Ritualiseren	Ritualiseerde	Geritualiseerd
Rivaliseren	Rivaliseerde	Gerivaliseerd
Robberen	Robberde	Gerobberd
Robotiseren	Robotiseerde	Gerobotiseerd
Rochelen	Rochelde	Gerocheld
Rock-'n-rollen	Rock-'n-rolde	Gerock-'n-rold
Rocken	Rockte	Gerockt
Rodelen	Rodelde	Gerodeld
Roderen	Rodeerde	Gerodeerd
Roefelen	Roefelde	Geroefeld
Roekoeken	Roekoekte	Geroekoekt
Roerbakken	Roerbakte	Geroerbakt
Roeten	Roette	Geroet
Roetsjen	Roetsjte	Geroetsjt
Roezemoezen	Roezemoesde	Geroezemoesd
Roezen	Roesde	Geroesd
Roffelen	Roffelde	Geroffeld
Rokeren	Rokeerde	Gerokeerd
Rokken	Rokte	Gerokt
Rollebollen	Rollebolde	Gerollebold
Rolleren	Rolleerde	Gerolleerd
Rolschaatsen	Rolschaatste	Gerolschaatst
Romaniseren	Romaniseerde	Geromaniseerd
Romantiseren	Romantiseerde	Geromantiseerd
Rommelen	Rommelde	Gerommeld
Ronden	Rondde	Gerond
Ronselen	Ronselde	Geronseld
Roosten	Roostte	Geroost
Roppen	Ropte	Geropt
Rossen	Roste	Gerost
Roten	Rootte	Geroot
Roteren	Roteerde	Geroteerd
Rotzooien	Rotzooide	Gerotzooid
Routeren	Routeerde	Gerouteerd
Rouwdouwen	Rouwdouwde	Gerouwdouwd
Rouwen	Rouwde	Gerouwd
Rouwklagen	Rouwklaagde	Gerouwklaagd
Rubriceren	Rubriceerde	Gerubriceerd
Ruften	Ruftte	Geruft
Rugbyen	Rugbyde	Gerugbyd
Ruien	Ruide	Geruid
Ruilebuiten	Ruilebuitte	Geruilebuit
Ruiten	Ruitte	Geruit
Ruiven	Ruifde	Geruifd
Ruizelen	Ruizelde	Geruizeld
Rukken	Rukte	Gerukt
Rumoeren	Rumoerde	Gerumoerd
Runnen	Runde	Gerund
Russificeren	Russificeerde	Gerussificeerd
Ruwen	Ruwde	Geruwd
Röntgenen	Röntgende	Geröntgend
		Web Storage
.com	.net	.org
.us	.ca	.tv
.biz	.info	.co.uk
Sabbelen	Sabbelde	Gesabbeld
Sabberen	Sabberde	Gesabberd
Sabelen	Sabelde	Gesabeld
Saboteren	Saboteerde	Gesaboteerd
Sacreren	Sacreerde	Gesacreerd
Sacrifiëren	Sacrifieerde	Gesacrifieerd
Sakkeren	Sakkerde	Gesakkerd
Salueren	Salueerde	Gesalueerd
Sammelen	Sammelde	Gesammeld
Samplen	Samplede	Gesampled
Sanctioneren	Sanctioneerde	Gesanctioneerd
Saneren	Saneerde	Gesaneerd
Sappelen	Sappelde	Gesappeld
Sapperen	Sappeerde	Gesappeerd
Sassen	Saste	Gesast
Satineren	Satineerde	Gesatineerd
Sausen	Sauste	Gesaust
Sauveren	Sauveerde	Gesauveerd
Sauzen	Sausde	Gesausd
Saven	Savede	Gesaved
Scalperen	Scalpeerde	Gescalpeerd
Scanderen	Scandeerde	Gescandeerd
Scannen	Scande	Gescand
Schaarden	Schaardde	Geschaard
Schaatsen	Schaatste	Geschaatst
Schaatsenrijden		
Schaffen	Schafte	Geschaft
Schaften	Schaftte	Geschaft
Schalen	Schaalde	Geschaald
Schallen	Schalde	Geschald
Schalmen	Schalmde	Geschalmd
Schamen	Schaamde	Geschaamd
Schampen	Schampte	Geschampt
Schamperen	Schamperde	Geschamperd
Schandaliseren	Schandaliseerde	Geschandaliseerd
Schandmerken	Schandmerkte	Geschandmerkt
Schandvlekken	Schandvlekte	Geschandvlekt
Scharen	Schaarde	Geschaard
Scharnieren	Scharnierde	Gescharnierd
Scharrelbenen	Scharrelbeende	Gescharrelbeend
Scharren	Scharde	Geschard
Schavelen	Schaveelde	Geschaveeld
Schaverdijnen	Schaverdijnde	Geschaverdijnd
Schavielen	Schavielde	Geschavield
Scheidsrechteren	Scheidsrechterde	Gescheidsrechterd
Schelden	Schold	Gescholden
Schematiseren	Schematiseerde	Geschematiseerd
Schemeren	Schemerde	Geschemerd
Schepen	Scheepte	Gescheept
Schermen	Schermde	Geschermd
Schermutselen	Schermutselde	Geschermutseld
Scherven	Scherfde	Gescherfd
Schetteren	Schetterde	Geschetterd
Scheuken	Scheukte	Gescheukt
Schiemannen	Schiemande	Geschiemand
Schilferen	Schilferde	Geschilferd
Schipperen	Schipperde	Geschipperd
Schmieren	Schmierde	Geschmierd
Schnabbelen	Schnabbelde	Geschnabbeld
Schobben	Schobde	Geschobd
Schoeien	Schoeide	Geschoeid
Schofferen	Schoffeerde	Geschoffeerd
Schokschouderen	Schokschouderde	Geschokschouderd
Scholpen	Scholpte	Gescholpt
Schonen	Schoonde	Geschoond
Schooieren	Schooierde	Geschooierd
Schoolmeesteren	Schoolmeesterde	Geschoolmeesterd
Schoonschrijven		
Schorten	Schortte	Geschort
Schotelen	Schotelde	Geschoteld
Schouderen	Schouderde	Geschouderd
Schoven	Schoofde	Geschoofd
Schrafelen	Schrafelde	Geschrafeld
Schrafferen	Schraffeerde	Geschraffeerd
Schralen	Schraalde	Geschraald
Schrankelen	Schrankelde	Geschrankeld
Schranken	Schrankte	Geschrankt
Schransen	Schranste	Geschranst
Schranzen	Schransde	Geschransd
Schrijbenen	Schrijbeende	Geschrijbeend
Schrijnen	Schrijnde	Geschrijnd
Schrobben	Schrobde	Geschrobd
Schroden	Schroodde	Geschrood
Schroeien	Schroeide	Geschroeid
Schroeven	Schroefde	Geschroefd
Schrokken	Schrokte	Geschrokt
Schrompelen	Schrompelde	Geschrompeld
Schrooien	Schrooide	Geschrooid
Schroten	Schrootte	Geschroot
Schubben	Schubde	Geschubd
Schuddebollen	Schuddebolde	Geschuddebold
Schuddebuiken	Schuddebuikte	Geschuddebuikt
Schuddekoppen	Schuddekopte	Geschuddekopt
Schuifelen	Schuifelde	Geschuifeld
Schuimbekken	Schuimbekte	Geschuimbekt
Schuinen	Schuinde	Geschuind
Schulpen	Schulpte	Geschulpt
Schurken	Schurkte	Geschurkt
Schutten	Schutte	Geschut
Schutteren	Schutterde	Geschutterd
Schuwen	Schuwde	Geschuwd
Scoren	Scoorde	Gescoord
Scrabbelen	Scrabbelde	Gescrabbeld
Scratchen	Scratchte	Gescratcht
Screenen	Screende	Gescreend
Scrollen	Scrolde	Gescrold
Scrubben	Scrubde	Gescrubd
Sealen	Sealde	Geseald
Seconderen	Secondeerde	Gesecondeerd
Seculariseren	Seculariseerde	Geseculariseerd
Sedenteren	Sedenteerde	Gesedenteerd
Segmenteren	Segmenteerde	Gesegmenteerd
Segregeren	Segregeerde	Gesegregeerd
Seizen	Seisde	Geseisd
Seksen	Sekste	Gesekst
Seksualiseren	Seksualiseerde	Geseksualiseerd
Sekwestreren	Sekwestreerde	Gesekwestreerd
Sensibiliseren	Sensibiliseerde	Gesensibiliseerd
Separeren	Separeerde	Gesepareerd
Seponeren	Seponeerde	Geseponeerd
Settelen	Settelde	Gesetteld
Shaken	Shakete	Geshaket
Shamponeren	Shamponeerde	Geshamponeerd
Shampooën	Shampoode	Geshampood
Shimmyen	Shimmyde	Geshimmyd
Shocken	Shockte	Geshockt
Shoppen	Shopte	Geshopt
Shorttracken	Shorttrackte	Geshorttrackt
Shotten	Shotte	Geshot
Showen	Showde	Geshowd
Sidderen	Sidderde	Gesidderd
Siepelen	Siepelde	Gesiepeld
Signeren	Signeerde	Gesigneerd
Sijfelen	Sijfelde	Gesijfeld
Sijpelen	Sijpelde	Gesijpeld
Simmen	Simde	Gesimd
Simpen	Simpte	Gesimpt
Simplificeren	Simplificeerde	Gesimplificeerd
Singelen	Singelde	Gesingeld
Sinteren	Sinterde	Gesinterd
Sjabloneren	Sjabloneerde	Gesjabloneerd
Sjachelen	Sjachelde	Gesjacheld
Sjacheren	Sjacherde	Gesjacherd
Sjansen	Sjanste	Gesjanst
Sjappen	Sjapte	Gesjapt
Sjezen	Sjeesde	Gesjeesd
Sjieken	Sjiekte	Gesjiekt
Sjoelbakken	Sjoelbakte	Gesjoelbakt
Sjoelen	Sjoelde	Gesjoeld
Sjoemelen	Sjoemelde	Gesjoemeld
Sjokken	Sjokte	Gesjokt
Sjorren	Sjorde	Gesjord
Sjotten	Sjotte	Gesjot
Sjouwen	Sjouwde	Gesjouwd
Skateboarden	Skateboardde	Geskateboard
Skaten	Skatete	Geskatet
Skeeleren	Skeelerde	Geskeelerd
Skeletteren	Skeletteerde	Geskeletteerd
Skelteren	Skelterde	Geskelterd
Skimmen	Skimde	Geskimd
Skiën	Skiede	Geskied
Skypen	Skypte	Geskypt
Slaapwandelen	Slaapwandelde	Geslaapwandeld
Slabakken	Slabakte	Geslabakt
Slabben	Slabde	Geslabd
Slabberen	Slabberde	Geslabberd
Slagregenen	Slagregende	Geslagregend
Slalommen	Slalomde	Geslalomd
Slampampen	Slampampte	Geslampampt
Slappen	Slapte	Geslapt
Slaven	Slaafde	Geslaafd
Slechten	Slechtte	Geslecht
Sleden	Sleedde	Gesleed
Sleepvoeten	Sleepvoette	Gesleepvoet
Sleeën	Sleede	Gesleed
Sleuren	Sleurde	Gesleurd
Sleutelen	Sleutelde	Gesleuteld
Slibben	Slibde	Geslibd
Slibberen	Slibberde	Geslibberd
Slichten	Slichtte	Geslicht
Slidderen	Slidderde	Geslidderd
Sliepen	Sliepte	Gesliept
Slieren	Slierde	Geslierd
Slijmen	Slijmde	Geslijmd
Slippen	Slipte	Geslipt
Slissen	Sliste	Geslist
Slobberen	Slobberde	Geslobberd
Slodderen	Slodderde	Geslodderd
Sloffen	Slofte	Gesloft
Slonzen	Slonsde	Geslonsd
Slooien	Slooide	Geslooid
Slorpen	Slorpte	Geslorpt
Sloten	Slootte	Gesloot
Sloven	Sloofde	Gesloofd
Sluikstorten	Sluikstortte	Gesluikstort
Sluipen	Sloop	Geslopen
Sluizen	Sluisde	Gesluisd
Slungelen	Slungelde	Geslungeld
Smaden	Smaadde	Gesmaad
Smakken	Smakte	Gesmakt
Smalen	Smaalde	Gesmaald
Smashen	Smashte	Gesmasht
Smeden	Smeedde	Gesmeed
Smeulen	Smeulde	Gesmeuld
Smiespelen	Smiespelde	Gesmiespeld
Smijdigen	Smijdigde	Gesmijdigd
Smikkelen	Smikkelde	Gesmikkeld
Smodderen	Smodderde	Gesmodderd
Smokken	Smokte	Gesmokt
Smotsen	Smotste	Gesmotst
Smousen	Smouste	Gesmoust
Smousjassen	Smousjaste	Gesmousjast
Smouten	Smoutte	Gesmout
Smouzen	Smousde	Gesmousd
Sms'en	Sms'te	Ge-sms't
Smukken	Smukte	Gesmukt
Smullen	Smulde	Gesmuld
Smulpapen	Smulpaapte	Gesmulpaapt
Snaaien	Snaaide	Gesnaaid
Snabbelen	Snabbelde	Gesnabbeld
Snakken	Snakte	Gesnakt
Snateren	Snaterde	Gesnaterd
Snauwen	Snauwde	Gesnauwd
Snebberen	Snebberde	Gesnebberd
Sneeuwballen	Sneeuwbalde	Gesneeuwbald
Sneeuwen	Sneeuwde	Gesneeuwd
Snepen	Sneepte	Gesneept
Sneren	Sneerde	Gesneerd
Snerken	Snerkte	Gesnerkt
Sneukelen	Sneukelde	Gesneukeld
Sneven	Sneefde	Gesneefd
Snezen	Sneesde	Gesneesd
Snibben	Snibde	Gesnibd
Snieren	Snierde	Gesnierd
Sniffen	Snifte	Gesnift
Snikken	Snikte	Gesnikt
Snipperen	Snipperde	Gesnipperd
Snoeken	Snoekte	Gesnoekt
Snoepen	Snoepte	Gesnoept
Snoeren	Snoerde	Gesnoerd
Snokken	Snokte	Gesnokt
Snookeren	Snookerde	Gesnookerd
Snorkelen	Snorkelde	Gesnorkeld
Snotteren	Snotterde	Gesnotterd
Snowboarden	Snowboardde	Gesnowboard
Snuffelen	Snuffelde	Gesnuffeld
Snuffen	Snufte	Gesnuft
Snuisteren	Snuisterde	Gesnuisterd
Socialiseren	Socialiseerde	Gesocialiseerd
Sodemieteren	Sodemieterde	Gesodemieterd
Soebatten	Soebatte	Gesoebat
Soezen	Soesde	Gesoesd
Softballen	Softbalde	Gesoftbald
Soigneren	Soigneerde	Gesoigneerd
Solderen	Soldeerde	Gesoldeerd
Solemniseren	Solemniseerde	Gesolemniseerd
Soleren	Soleerde	Gesoleerd
Solfegiëren	Solfegieerde	Gesolfegieerd
Solidariseren	Solidariseerde	Gesolidariseerd
Solideren	Solideerde	Gesolideerd
Sollen	Solde	Gesold
Solliciteren	Solliciteerde	Gesolliciteerd
Solmiëren	Solmieerde	Gesolmieerd
Somberen	Somberde	Gesomberd
Souffleren	Souffleerde	Gesouffleerd
Soundmixen	Soundmixte	Gesoundmixt
Soutacheren	Soutacheerde	Gesoutacheerd
Souteneren	Souteneerde	Gesouteneerd
Sovjetiseren	Sovjetiseerde	Gesovjetiseerd
Spachtelputzen	Spachtelputzte	Gespachtelputzt
Spaden	Spaadde	Gespaad
Spalken	Spalkte	Gespalkt
Spanen	Spaande	Gespaand
Spankeren	Spankerde	Gespankerd
Spanseren	Spanseerde	Gespanseerd
Sparkelen	Sparkelde	Gesparkeld
Sparren	Sparde	Gespard
Spartelbenen	Spartelbeende	Gespartelbeend
Spatten	Spatte	Gespat
Specialiseren	Specialiseerde	Gespecialiseerd
Specificeren	Specificeerde	Gespecificeerd
Speculeren	Speculeerde	Gespeculeerd
Speechen	Speechte	Gespeecht
Spelden	Speldde	Gespeld
Speldenwerken	Speldenwerkte	Gespeldenwerkt
Spelemeien	Spelemeide	Gespelemeid
Spelevaren	Spelevaarde	Gespelevaard
Spellen	Spelde	Gespeld
Spenen	Speende	Gespeend
Sperren	Sperde	Gesperd
Speten	Speette	Gespeet
Spetten	Spette	Gespet
Spetteren	Spetterde	Gespetterd
Speuren	Speurde	Gespeurd
Spieken	Spiekte	Gespiekt
Spieren	Spierde	Gespierd
Spietsen	Spietste	Gespietst
Spijbelen	Spijbelde	Gespijbeld
Spijten	Speet	Gespeten
Spijzen	Spijsde	Gespijsd
Spikkelen	Spikkelde	Gespikkeld
Spillen	Spilde	Gespild
Spinnen	Spinde	Gespind
Spinnen	Spon	Gesponnen
Spinzen	Spinsde	Gespinsd
Spiralen	Spiraalde	Gespiraald
Spirantiseren	Spirantiseerde	Gespirantiseerd
Spitsen	Spitste	Gespitst
Splinteren	Splinterde	Gesplinterd
Splitten	Splitte	Gesplit
Spoeden	Spoedde	Gespoed
Spoken	Spookte	Gespookt
Spoliëren	Spolieerde	Gespolieerd
Sponsen	Sponste	Gesponst
Sponzen	Sponsde	Gesponsd
Sporen	Spoorde	Gespoord
Sporten	Sportte	Gesport
Spotlachen	Spotlachte	Gespotlacht
Spouwen	Spouwde	Gespouwen
Sprankelen	Sprankelde	Gesprankeld
Sprayen	Sprayde	Gesprayd
Sprengen	Sprengde	Gesprengd
Sprieten	Spriette	Gespriet
Sprietogen	Sprietoogde	Gesprietoogd
Spritsen	Spritste	Gespritst
Sprokkelen	Sprokkelde	Gesprokkeld
Spuiten	Spoot	Gespoten
Spurten	Spurtte	Gespurt
Squashen	Squashte	Gesquasht
Staartdelen	Staartdeelde	Gestaartdeeld
Stabiliseren	Stabiliseerde	Gestabiliseerd
Staffelen	Staffelde	Gestaffeld
Stagediven	Stagedivede	Gestagedived
Stagen	Staagde	Gestaagd
Stakelen	Stakelde	Gestakeld
Staken	Staakte	Gestaakt
Stalken	Stalkte	Gestalkt
Stallen	Stalde	Gestald
Stammen	Stamde	Gestamd
Standaardiseren	Standaardiseerde	Gestandaardiseerd
Stangen	Stangde	Gestangd
Stansen	Stanste	Gestanst
Staren	Staarde	Gestaard
Starogen	Staroogde	Gestaroogd
Statten	Statte	Gestat
Statussen	Statuste	Gestatust
Steendrukken	Steendrukte	Gesteendrukt
Steengrillen	Steengrilde	Gesteengrild
Steggelen	Steggelde	Gesteggeld
Steigeren	Steigerde	Gesteigerd
Stekken	Stekte	Gestekt
Stencilen	Stencilde	Gestencild
Stenen	Steende	Gesteend
Stenigen	Stenigde	Gestenigd
Stenograferen	Stenografeerde	Gestenografeerd
Stenotypen	Stenotypte	Gestenotypt
Steppen	Stepte	Gestept
Stereotyperen	Stereotypeerde	Gestereotypeerd
Steriliseren	Steriliseerde	Gesteriliseerd
Steuren	Steurde	Gesteurd
Stevenen	Stevende	Gestevend
Stiefelen	Stiefelde	Gestiefeld
Stiften	Stiftte	Gestift
Stigmatiseren	Stigmatiseerde	Gestigmatiseerd
Stijfselen	Stijfselde	Gestijfseld
Stikken	Stikte	Gestikt
Stinken	Stonk	Gestonken
Stipendiëren	Stipendieerde	Gestipendieerd
Stippelen	Stippelde	Gestippeld
Stippen	Stipte	Gestipt
Stockeren	Stockeerde	Gestockeerd
Stoefen	Stoefte	Gestoeft
Stoelen	Stoelde	Gestoeld
Stoepen	Stoepte	Gestoept
Stofhagelen	Stofhagelde	Gestofhageld
Stofregenen	Stofregende	Gestofregend
Stofzuigen	Stofzuigde	Gestofzuigd
Stofzuigeren	Stofzuigerde	Gestofzuigerd
Stokken	Stokte	Gestokt
Stolpen	Stolpte	Gestolpt
Stommelen	Stommelde	Gestommeld
Stompen	Stompte	Gestompt
Stormen	Stormde	Gestormd
Storneren	Storneerde	Gestorneerd
Stortregenen	Stortregende	Gestortregend
Straatracen	Straatracete	Gestraatracet
Stralen	Straalde	Gestraald
Strategoën	Strategode	Gestrategood
Streaken	Streakte	Gestreakt
Strengen	Strengde	Gestrengd
Strepen	Streepte	Gestreept
Stressen	Streste	Gestrest
Stresseren	Stresseerde	Gestresseerd
Stretchen	Stretchte	Gestretcht
Stribbelen	Stribbelde	Gestribbeld
Strippen	Stripte	Gestript
Stroken	Strookte	Gestrookt
Strompelen	Strompelde	Gestrompeld
Stroomlijnen	Stroomlijnde	Gestroomlijnd
Stroppen	Stropte	Gestropt
Strossen	Stroste	Gestrost
Strubbelen	Strubbelde	Gestrubbeld
Structureren	Structureerde	Gestructureerd
Struikelen	Struikelde	Gestruikeld
Struinen	Struinde	Gestruind
Stuffen	Stufte	Gestuft
Stuiken	Stuikte	Gestuikt
Stuiptrekken	Stuiptrekte	Gestuiptrekt
Stuken	Stuukte	Gestuukt
Stukeren	Stukeerde	Gestukeerd
Stulpen	Stulpte	Gestulpt
Stumperen	Stumperde	Gestumperd
Stuntelen	Stuntelde	Gestunteld
Stunten	Stuntte	Gestunt
Sublimeren	Sublimeerde	Gesublimeerd
Subordineren	Subordineerde	Gesubordineerd
Subsidiëren	Subsidieerde	Gesubsidieerd
Substantiveren	Substantiveerde	Gesubstantiveerd
Sudderen	Sudderde	Gesudderd
Suffen	Sufte	Gesuft
Suikeren	Suikerde	Gesuikerd
Suilen	Suilde	Gesuild
Suizebollen	Suizebolde	Gesuizebold
Sukkelen	Sukkelde	Gesukkeld
Sullen	Sulde	Gesuld
Superviseren	Superviseerde	Gesuperviseerd
Suppleren	Suppleerde	Gesuppleerd
Suppliëren	Supplieerde	Gesupplieerd
Supporteren	Supporterde	Gesupporterd
Supprimeren	Supprimeerde	Gesupprimeerd
Surinamiseren	Surinamiseerde	Gesurinamiseerd
Surplacen	Surplacete	Gesurplacet
Survivallen	Survivalde	Gesurvivald
Suspenderen	Suspendeerde	Gesuspendeerd
Sussen	Suste	Gesust
Switchen	Switchte	Geswitcht
Synchroniseren	Synchroniseerde	Gesynchroniseerd
Syncoperen	Syncopeerde	Gesyncopeerd
Syndiceren	Syndiceerde	Gesyndiceerd
Synthetiseren	Synthetiseerde	Gesynthetiseerd
Systematiseren	Systematiseerde	Gesystematiseerd
Tabellariseren	Tabellariseerde	Getabellariseerd
Tabernakelen	Tabernakelde	Getabernakeld
Tabuleren	Tabuleerde	Getabuleerd
Tafelen	Tafelde	Getafeld
Tafeltennissen	Tafeltenniste	Getafeltennist
Tai-chiën	Tai-chiede	Getai-chied
Tailleren	Tailleerde	Getailleerd
Takelen	Takelde	Getakeld
Taken	Taakte	Getaakt
Takken	Takte	Getakt
Talen	Taalde	Getaald
Taliën	Taliede	Getalied
Talmen	Talmde	Getalmd
Tamboeren	Tamboerde	Getamboerd
Tamboereren	Tamboereerde	Getamboereerd
Tampen	Tampte	Getampt
Tamponneren	Tamponneerde	Getamponneerd
Tanden	Tandde	Getand
Tandenknarsen	Tandenknarste	Getandenknarst
Tanken	Tankte	Getankt
Tantaliseren	Tantaliseerde	Getantaliseerd
Tapdansen	Tapdanste	Getapdanst
Tapen	Tapete	Getapet
Tappelen	Tappelde	Getappeld
Tariferen	Tarifeerde	Getarifeerd
Tarnen	Tarnde	Getarnd
Tarreren	Tarreerde	Getarreerd
Tassen	Taste	Getast
Tateren	Taterde	Getaterd
Tatoeëren	Tatoeëerde	Getatoeëerd
Taxiën	Taxiede	Getaxied
Tectyleren	Tectyleerde	Getectyleerd
Teemsen	Teemste	Geteemst
Teerlingen	Teerlingde	Geteerlingd
Telebankieren	Telebankierde	Getelebankierd
Telegraferen	Telegrafeerde	Getelegrafeerd
Telescoperen	Telescopeerde	Getelescopeerd
Telewerken	Telewerkte	Getelewerkt
Telexen	Telexte	Getelext
Temen	Teemde	Geteemd
Tempeesten	Tempeestte	Getempeest
Tempelen	Tempelde	Getempeld
Tempen	Tempte	Getempt
Temperaturen	Temperatuurde	Getemperatuurd
Temporiseren	Temporiseerde	Getemporiseerd
Tempteren	Tempteerde	Getempteerd
Tenderen	Tendeerde	Getendeerd
Tengelen	Tengelde	Getengeld
Tennissen	Tenniste	Getennist
Tentamineren	Tentamineerde	Getentamineerd
Tenteren	Tenteerde	Getenteerd
Teren	Teerde	Geteerd
Termineren	Termineerde	Getermineerd
Terrasseren	Terrasseerde	Geterrasseerd
Testeren	Testeerde	Getesteerd
Tetteren	Tetterde	Getetterd
Teugelen	Teugelde	Geteugeld
Teuten	Teutte	Geteut
Teuteren	Teuterde	Geteuterd
Tezen	Teesde	Geteesd
Thematiseren	Thematiseerde	Gethematiseerd
Theologiseren	Theologiseerde	Getheologiseerd
Theoretiseren	Theoretiseerde	Getheoretiseerd
Tichelen	Tichelde	Geticheld
Tierelieren	Tierelierde	Getierelierd
Tijgeren	Tijgerde	Getijgerd
Tikkelen	Tikkelde	Getikkeld
Tiktakken	Tiktakte	Getiktakt
Timen	Timede	Getimed
Tinkelen	Tinkelde	Getinkeld
Tinken	Tinkte	Getinkt
Tippen	Tipte	Getipt
Tirailleren	Tirailleerde	Getirailleerd
Tiranniseren	Tiranniseerde	Getiranniseerd
Tirasseren	Tirasseerde	Getirasseerd
Titelen	Titelde	Getiteld
Titreren	Titreerde	Getitreerd
Tituleren	Tituleerde	Getituleerd
Tiërceren	Tiërceerde	Getiërceerd
Tjangelen	Tjangelde	Getjangeld
Tjappen	Tjapte	Getjapt
Tjingelen	Tjingelde	Getjingeld
Tjirpen	Tjirpte	Getjirpt
Tjoempen	Tjoempte	Getjoempt
Tjoepen	Tjoepte	Getjoept
Tjokken	Tjokte	Getjokt
Toasten	Toastte	Getoast
Tobben	Tobde	Getobd
Tochten	Tochtte	Getocht
Toepen	Toepte	Getoept
Toeren	Toerde	Getoerd
Toernooien	Toernooide	Getoernooid
Toeteren	Toeterde	Getoeterd
Toiletteren	Toiletteerde	Getoiletteerd
Tokken	Tokte	Getokt
Tolken	Tolkte	Getolkt
Tollen	Tolde	Getold
Tomen	Toomde	Getoomd
Tongen	Tongde	Getongd
Tongzoenen	Tongzoende	Getongzoend
Tonnen	Tonde	Getond
Toonzetten	Toonzette	Getoonzet
Toosten	Toostte	Getoost
Toppen	Topte	Getopt
Torderen	Tordeerde	Getordeerd
Torenen	Torende	Getorend
Tormenteren	Tormenteerde	Getormenteerd
Tornooien	Tornooide	Getornooid
Torpederen	Torpedeerde	Getorpedeerd
Torsen	Torste	Getorst
Tortelen	Tortelde	Getorteld
Tossen	Toste	Getost
Totaliseren	Totaliseerde	Getotaliseerd
Touperen	Toupeerde	Getoupeerd
Touwen	Touwde	Getouwd
Traanogen	Traanoogde	Getraanoogd
Traceren	Traceerde	Getraceerd
Traineren	Traineerde	Getraineerd
Traliën	Traliede	Getralied
Trammen	Tramde	Getramd
Tranen	Traande	Getraand
Transcenderen	Transcendeerde	Getranscendeerd
Transcriberen	Transcribeerde	Getranscribeerd
Transfereren	Transfereerde	Getransfereerd
Transfigureren	Transfigureerde	Getransfigureerd
Transformeren	Transformeerde	Getransformeerd
Transigeren	Transigeerde	Getransigeerd
Transmuteren	Transmuteerde	Getransmuteerd
Transponeren	Transponeerde	Getransponeerd
Trassen	Traste	Getrast
Trasseren	Trasseerde	Getrasseerd
Traumatiseren	Traumatiseerde	Getraumatiseerd
Traven	Traafde	Getraafd
Traverseren	Traverseerde	Getraverseerd
Treilen	Treilde	Getreild
Treinen	Treinde	Getreind
Treinsurfen	Treinsurfte	Getreinsurft
Treiteren	Treiterde	Getreiterd
Trekkebekken	Trekkebekte	Getrekkebekt
Trekkebenen	Trekkebeende	Getrekkebeend
Tremmen	Tremde	Getremd
Tremuleren	Tremuleerde	Getremuleerd
Trenzen	Trensde	Getrensd
Trepaneren	Trepaneerde	Getrepaneerd
Treuren	Treurde	Getreurd
Treuzelen	Treuzelde	Getreuzeld
Trijsen	Trijste	Getrijst
Trijzelen	Trijzelde	Getrijzeld
Triktrakken	Triktrakte	Getriktrakt
Triomferen	Triomfeerde	Getriomfeerd
Tripleren	Tripleerde	Getripleerd
Tripliceren	Tripliceerde	Getripliceerd
Trippelen	Trippelde	Getrippeld
Trippen	Tripte	Getript
Triptrappen	Triptrapte	Getriptrapt
Trissen	Triste	Getrist
Tritsen	Tritste	Getritst
Trivialiseren	Trivialiseerde	Getrivialiseerd
Triëren	Trieerde	Getrieerd
Troebleren	Troebleerde	Getroebleerd
Troeven	Troefde	Getroefd
Troggelen	Troggelde	Getroggeld
Trommen	Tromde	Getromd
Trompen	Trompte	Getrompt
Trompetten	Trompette	Getrompet
Trompetteren	Trompetterde	Getrompetterd
Tronen	Troonde	Getroond
Trossen	Troste	Getrost
Trukeren	Trukeerde	Getrukeerd
Tsjilpen	Tsjilpte	Getsjilpt
Tuchtigen	Tuchtigde	Getuchtigd
Tuffen	Tufte	Getuft
Tuien	Tuide	Getuid
Tuieren	Tuierde	Getuierd
Tuimelen	Tuimelde	Getuimeld
Tuinen	Tuinde	Getuind
Tuinieren	Tuinierde	Getuinierd
Tuisen	Tuiste	Getuist
Tuitelen	Tuitelde	Getuiteld
Tukken	Tukte	Getukt
Tunnelen	Tunnelde	Getunneld
Turen	Tuurde	Getuurd
Turken	Turkte	Geturkt
Turnen	Turnde	Geturnd
Turven	Turfde	Geturfd
Tutten	Tutte	Getut
Tweernen	Tweernde	Getweernd
Twitteren	Twitterde	Getwitterd
Typecasten	Typecastte	Getypecast
Unificeren	Unificeerde	Geünificeerd
Uniformeren	Uniformeerde	Geüniformeerd
Uniëren	Unieerde	Geünieerd
Unzippen	Unzipte	Geünzipt
Upgraden	Upgradede	Geüpgraded
Uploaden	Uploadde	Geüpload
Urbaniseren	Urbaniseerde	Geürbaniseerd
Urmen	Urmde	Geürmd
Utiliseren	Utiliseerde	Geütiliseerd
Vaderen	Vaderde	Gevaderd
Vagebonderen	Vagebondeerde	Gevagebondeerd
Vagen	Vaagde	Gevaagd
Valideren	Valideerde	Gevalideerd
Valoriseren	Valoriseerde	Gevaloriseerd
Valuteren	Valuteerde	Gevaluteerd
Vaporiseren	Vaporiseerde	Gevaporiseerd
Variabiliseren	Variabiliseerde	Gevariabiliseerd
Vasten	Vastte	Gevast
Vaten	Vaatte	Gevaat
Vedelen	Vedelde	Gevedeld
Veesten	Veestte	Geveest
Veilen	Veilde	Geveild
Velouteren	Velouteerde	Gevelouteerd
Vendelen	Vendelde	Gevendeld
Veraangenamen	Veraangenaamde	Veraangenaamd
Verabsoluteren	Verabsoluteerde	Verabsoluteerd
Verachtelozen	Verachteloosde	Verachteloosd
Verachten	Verachtte	Veracht
Verachteren	Verachterde	Verachterd
Verachtvoudigen	Verachtvoudigde	Verachtvoudigd
Verademen	Verademde	Verademd
Veralgemeniseren	Veralgemeniseerde	Veralgemeniseerd
Veramerikaansen	Veramerikaanste	Veramerikaanst
Veramerikaniseren	Veramerikaniseerde	Veramerikaniseerd
Verankeren	Verankerde	Verankerd
Verarmen	Verarmde	Verarmd
Verbabbelen	Verbabbelde	Verbabbeld
Verbakken	Verbakte	Verbakken
Verbedden	Verbedde	Verbed
Verbeestelijken	Verbeestelijkte	Verbeestelijkt
Verbeesten	Verbeestte	Verbeest
Verbeiden	Verbeidde	Verbeid
Verbenen	Verbeende	Verbeend
Verbeulemansen	Verbeulemanste	Verbeulemanst
Verbeuzelen	Verbeuzelde	Verbeuzeld
Verbidden	Verbad	Verbeden
Verbieden	Verbood	Verboden
Verbijten	Verbeet	Verbeten
Verbijzonderen	Verbijzonderde	Verbijzonderd
Verbleken	Verbleekte	Verbleekt
Verblikken	Verblikte	Verblikt
Verbloeden	Verbloedde	Verbloed
Verblozen	Verbloosde	Verbloosd
Verbodemen	Verbodemde	Verbodemd
Verboemelen	Verboemelde	Verboemeld
Verboeren	Verboerde	Verboerd
Verboersen	Verboerste	Verboerst
Verboeten	Verboette	Verboet
Verbraken	Verbraakte	Verbraakt
Verbroddelen	Verbroddelde	Verbroddeld
Verbrodden	Verbrodde	Verbrod
Verbroederen	Verbroederde	Verbroederd
Verbroeien	Verbroeide	Verbroeid
Verbruien	Verbruide	Verbruid
Verburgerlijken	Verburgerlijkte	Verburgerlijkt
Verchromen	Verchroomde	Verchroomd
Vercijferen	Vercijferde	Vercijferd
Vercommercialiseren	Vercommercialiseerde	Vercommercialiseerd
Verdapperen	Verdapperde	Verdapperd
Verdeemoedigen	Verdeemoedigde	Verdeemoedigd
Verdenken	Verdacht	Verdacht
Verderven	Verdierf	Verdorven
Verdiepen	Verdiepte	Verdiept
Verdierlijken	Verdierlijkte	Verdierlijkt
Verdietsen	Verdietste	Verdietst
Verdijen	Verdijde	Verdijd
Verdisconteren	Verdisconteerde	Verdisconteerd
Verdobbelen	Verdobbelde	Verdobbeld
Verdoeken	Verdoekte	Verdoekt
Verdoemen	Verdoemde	Verdoemd
Verdoffen	Verdofte	Verdoft
Verdokteren	Verdokterde	Verdokterd
Verdommen	Verdomde	Verdomd
Verdonkeremanen	Verdonkeremaande	Verdonkeremaand
Verdonkeren	Verdonkerde	Verdonkerd
Verdopen	Verdoopte	Verdoopt
Verdriedubbelen	Verdriedubbelde	Verdriedubbeld
Verdrieten	Verdroot	Verdroten
Verdrievoudigen	Verdrievoudigde	Verdrievoudigd
Verdrogen	Verdroogde	Verdroogd
Verdromen	Verdroomde	Verdroomd
Verdubbelen	Verdubbelde	Verdubbeld
Verduffen	Verdufte	Verduft
Verduidelijken	Verduidelijkte	Verduidelijkt
Verduiken	Verdook	Verdoken
Verduisteren	Verduisterde	Verduisterd
Verduitsen	Verduitste	Verduitst
Verduizendvoudigen	Verduizendvoudigde	Verduizendvoudigd
Verdutten	Verdutte	Verdut
Verduurzamen	Verduurzaamde	Verduurzaamd
Verdwazen	Verdwaasde	Verdwaasd
Vereelten	Vereeltte	Vereelt
Vereenzamen	Vereenzaamde	Vereenzaamd
Vereeuwigen	Vereeuwigde	Vereeuwigd
Veren	Veerde	Geveerd
Verenen	Vereende	Vereend
Verengelsen	Verengelste	Verengelst
Verengen	Verengde	Verengd
Verenkelen	Verenkelde	Verenkeld
Vererven	Vererfde	Vererfd
Veresteren	Veresterde	Veresterd
Veretteren	Veretterde	Veretterd
Vereuropesen	Vereuropeeste	Vereuropeest
Verevenen	Verevende	Verevend
Verfommelen	Verfommelde	Verfommeld
Verfraaien	Verfraaide	Verfraaid
Verfransen	Verfranste	Verfranst
Verfrissen	Verfriste	Verfrist
Verfronselen	Verfronselde	Verfronseld
Verfuiven	Verfuifde	Verfuifd
Vergalopperen	Vergaloppeerde	Vergaloppeerd
Vergapen	Vergaapte	Vergaapt
Vergaren	Vergaarde	Vergaard
Vergarsten	Vergarstte	Vergarst
Vergassen	Vergaste	Vergast
Vergeestelijken	Vergeestelijkte	Vergeestelijkt
Vergelen	Vergeelde	Vergeeld
Vergenoegen	Vergenoegde	Vergenoegd
Vergewissen	Vergewiste	Vergewist
Vergezellen	Vergezelde	Vergezeld
Vergezelschappen	Vergezelschapte	Vergezelschapt
Vergisten	Vergistte	Vergist
Verglazen	Verglaasde	Verglaasd
Verglijden	Vergleed	Vergleden
Verglimmen	Verglom	Verglommen
Vergoddelijken	Vergoddelijkte	Vergoddelijkt
Vergoden	Vergoodde	Vergood
Vergoelijken	Vergoelijkte	Vergoelijkt
Vergokken	Vergokte	Vergokt
Vergooien	Vergooide	Vergooid
Vergrammen	Vergramde	Vergramd
Vergrauwen	Vergrauwde	Vergrauwd
Vergraven	Vergroef	Vergraven
Vergrendelen	Vergrendelde	Vergrendeld
Vergrijpen	Vergreep	Vergrepen
Vergrijzen	Vergrijsde	Vergrijsd
Vergroeien	Vergroeide	Vergroeid
Vergroven	Vergroofde	Vergroofd
Vergruizelen	Vergruizelde	Vergruizeld
Vergruizen	Vergruisde	Vergruisd
Verguizen	Verguisde	Verguisd
Vergulden	Verguldde	Verguld
Verhabbezakken	Verhabbezakte	Verhabbezakt
Verhagelen	Verhagelde	Verhageld
Verhakkelen	Verhakkelde	Verhakkeld
Verhakken	Verhakte	Verhakt
Verhakselen	Verhakselde	Verhakseld
Verhakstukken	Verhakstukte	Verhakstukt
Verhalvezolen	Verhalvezoolde	Verhalvezoold
Verhangen	Verhing	Verhangen
Verhanselen	Verhanselde	Verhanseld
Verhapstukken	Verhapstukte	Verhapstukt
Verharden	Verhardde	Verhard
Verharen	Verhaarde	Verhaard
Verheerlijken	Verheerlijkte	Verheerlijkt
Verheien	Verheide	Verheid
Verheimelijken	Verheimelijkte	Verheimelijkt
Verhevigen	Verhevigde	Verhevigd
Verhippen	Verhipte	Verhipt
Verhoefslagen	Verhoefslaagde	Verhoefslaagd
Verhoeren	Verhoerde	Verhoerd
Verhollandsen	Verhollandste	Verhollandst
Verhonderdvoudigen	Verhonderdvoudigde	Verhonderdvoudigd
Verhongeren	Verhongerde	Verhongerd
Verhoornen	Verhoornde	Verhoornd
Verhopen	Verhoopte	Verhoopt
Verhoren	Verhoorde	Verhoord
Verhouden	Verhield	Verhouden
Verhovaardigen	Verhovaardigde	Verhovaardigd
Verhuizen	Verhuisde	Verhuisd
Verhullen	Verhulde	Verhuld
Verhuren	Verhuurde	Verhuurd
Verhypothekeren	Verhypothekeerde	Verhypothekeerd
Verijdeltuiten	Verijdeltuitte	Verijdeltuit
Verijzen	Verijsde	Verijsd
Verindischen	Verindischte	Verindischt
Verinlandsen	Verinlandste	Verinlandst
Verinnerlijken	Verinnerlijkte	Verinnerlijkt
Verinnigen	Verinnigde	Verinnigd
Verinteresten	Verinterestte	Verinterest
Verintresten	Verintrestte	Verintrest
Verjeugdigen	Verjeugdigde	Verjeugdigd
Verjongen	Verjongde	Verjongd
Verkalken	Verkalkte	Verkalkt
Verkankeren	Verkankerde	Verkankerd
Verkappen	Verkapte	Verkapt
Verkassen	Verkaste	Verkast
Verkavelen	Verkavelde	Verkaveld
Verkazen	Verkaasde	Verkaasd
Verketteren	Verketterde	Verketterd
Verkeuren	Verkeurde	Verkeurd
Verkielen	Verkielde	Verkield
Verkijken	Verkeek	Verkeken
Verkillen	Verkilde	Verkild
Verkindsen	Verkindste	Verkindst
Verkladden	Verkladde	Verklad
Verklanken	Verklankte	Verklankt
Verklappen	Verklapte	Verklapt
Verkleinen	Verkleinde	Verkleind
Verkletsen	Verkletste	Verkletst
Verkleumen	Verkleumde	Verkleumd
Verklinken	Verklonk	Verklonken
Verkloeken	Verkloekte	Verkloekt
Verkloten	Verklootte	Verkloot
Verknallen	Verknalde	Verknald
Verknechten	Verknechtte	Verknecht
Verkneukelen	Verkneukelde	Verkneukeld
Verkneuteren	Verkneuterde	Verkneuterd
Verkniezen	Verkniesde	Verkniesd
Verknijpen	Verkneep	Verknepen
Verknippen	Verknipte	Verknipt
Verknollen	Verknolde	Verknold
Verknopen	Verknoopte	Verknoopt
Verknutselen	Verknutselde	Verknutseld
Verkoken	Verkookte	Verkookt
Verkokeren	Verkokerde	Verkokerd
Verkolen	Verkoolde	Verkoold
Verkommeren	Verkommerde	Verkommerd
Verkonden	Verkondde	Verkond
Verkondschappen	Verkondschapte	Verkondschapt
Verkonkelen	Verkonkelde	Verkonkeld
Verkoperen	Verkoperde	Verkoperd
Verkorrelen	Verkorrelde	Verkorreld
Verkorsten	Verkorstte	Verkorst
Verkrampen	Verkrampte	Verkrampt
Verkrappen	Verkrapte	Verkrapt
Verkreuken	Verkreukte	Verkreukt
Verkrimpen	Verkromp	Verkrompen
Verkrommen	Verkromde	Verkromd
Verkrotten	Verkrotte	Verkrot
Verkruien	Verkruide	Verkruid
Verkuilen	Verkuilde	Verkuild
Verkwanselen	Verkwanselde	Verkwanseld
Verkwijnen	Verkwijnde	Verkwijnd
Verkwikken	Verkwikte	Verkwikt
Verlangzamen	Verlangzaamde	Verlangzaamd
Verlanterfanten	Verlanterfantte	Verlanterfant
Verlappen	Verlapte	Verlapt
Verledigen	Verledigde	Verledigd
Verleien	Verleide	Verleid
Verlelijken	Verlelijkte	Verlelijkt
Verletten	Verlette	Verlet
Verleuteren	Verleuterde	Verleuterd
Verlezen	Verlas	Verlezen
Verliederlijken	Verliederlijkte	Verliederlijkt
Verlieven	Verliefde	Verliefd
Verliggen	Verlag	Verlegen
Verlijden	Verleed	Verleden
Verlijmen	Verlijmde	Verlijmd
Verlinken	Verlinkte	Verlinkt
Verlinksen	Verlinkste	Verlinkst
Verloden	Verloodde	Verlood
Verloederen	Verloederde	Verloederd
Verlonen	Verloonde	Verloond
Verloochenen	Verloochende	Verloochend
Verloten	Verlootte	Verloot
Verloven	Verloofde	Verloofd
Verluchtigen	Verluchtigde	Verluchtigd
Verluiden	Verluidde	Verluid
Verluieren	Verluierde	Verluierd
Verlullen	Verlulde	Verluld
Verlummelen	Verlummelde	Verlummeld
Verlustigen	Verlustigde	Verlustigd
Vermaagschappen	Vermaagschapte	Vermaagschapt
Vermaledijden	Vermaledijdde	Vermaledijd
Vermaledijen	Vermaledijde	Vermaledijd
Vermangelen	Vermangelde	Vermangeld
Vermannelijken	Vermannelijkte	Vermannelijkt
Vermannen	Vermande	Vermand
Vermarkten	Vermarktte	Vermarkt
Vermassacreren	Vermassacreerde	Vermassacreerd
Vermeesteren	Vermeesterde	Vermeesterd
Vermeien	Vermeide	Vermeid
Vermemelen	Vermemelde	Vermemeld
Vermenen	Vermeende	Vermeend
Vermenigvuldigen	Vermenigvuldigde	Vermenigvuldigd
Vermenselijken	Vermenselijkte	Vermenselijkt
Vermeten	Vermat	Vermeten
Vermiljoenen	Vermiljoende	Gevermiljoend
Vermissen	Vermiste	Vermist
Vermoeren	Vermoerde	Vermoerd
Vermoffelen	Vermoffelde	Vermoffeld
Vermoffen	Vermofte	Vermoft
Vermogen	Vermocht	Vermocht
Vermolmen	Vermolmde	Vermolmd
Vermooien	Vermooide	Vermooid
Vermuffen	Vermufte	Vermuft
Vermunten	Vermuntte	Vermunt
Vernaaien	Vernaaide	Vernaaid
Vernachelen	Vernachelde	Vernacheld
Vernachten	Vernachtte	Vernacht
Vernagelen	Vernagelde	Vernageld
Vernauwen	Vernauwde	Vernauwd
Vernederlandsen	Vernederlandste	Vernederlandst
Vernestelen	Vernestelde	Vernesteld
Verneuken	Verneukte	Verneukt
Verneurien	Verneuriede	Verneuried
Vernevelen	Vernevelde	Verneveld
Vernieuwerwetsen	Vernieuwerwetste	Vernieuwerwetst
Vernikkelen	Vernikkelde	Vernikkeld
Vernissen	Verniste	Gevernist
Vernoemen	Vernoemde	Vernoemd
Vernummeren	Vernummerde	Vernummerd
Veronaangenamen	Veronaangenaamde	Veronaangenaamd
Verontwaardigen	Verontwaardigde	Verontwaardigd
Veropenbaren	Veropenbaarde	Veropenbaard
Verordineren	Verordineerde	Verordineerd
Verordonneren	Verordonneerde	Verordonneerd
Verouwelijken	Verouwelijkte	Verouwelijkt
Veroveren	Veroverde	Veroverd
Verpachten	Verpachtte	Verpacht
Verpappen	Verpapte	Verpapt
Verpatsen	Verpatste	Verpatst
Verpauperen	Verpauperde	Verpauperd
Verpekelen	Verpekelde	Verpekeld
Verpersoonlijken	Verpersoonlijkte	Verpersoonlijkt
Verpieteren	Verpieterde	Verpieterd
Verpinken	Verpinkte	Verpinkt
Verpletten	Verplette	Verplet
Verplooien	Verplooide	Verplooid
Verpolitieken	Verpolitiekte	Verpolitiekt
Verpompen	Verpompte	Verpompt
Verpoppen	Verpopte	Verpopt
Verpotten	Verpotte	Verpot
Verpozen	Verpoosde	Verpoosd
Verpraten	Verpraatte	Verpraat
Verprotestantsen	Verprotestantste	Verprotestantst
Verrafelen	Verrafelde	Verrafeld
Verramsjen	Verramsjte	Verramsjt
Verrechtsen	Verrechtste	Verrechtst
Verrechtvaardigen	Verrechtvaardigde	Verrechtvaardigd
Verregenen	Verregende	Verregend
Verreiken	Verreikte	Verreikt
Verreizen	Verreisde	Verreisd
Verrekenen	Verrekende	Verrekend
Verrijden	Verreed	Verreden
Verrijken	Verrijkte	Verrijkt
Verrimpelen	Verrimpelde	Verrimpeld
Verroeien	Verroeide	Verroeid
Verroesten	Verroestte	Verroest
Verroken	Verrookte	Verrookt
Verrollen	Verrolde	Verrold
Verronselen	Verronselde	Verronseld
Verroomsen	Verroomste	Verroomst
Verruigen	Verruigde	Verruigd
Verruwen	Verruwde	Verruwd
Versassen	Versaste	Versast
Verschalen	Verschaalde	Verschaald
Verscharen	Verschaarde	Verschaard
Verschelen	Verscheelde	Verscheeld
Verschenken	Verschonk	Verschonken
Verschepen	Verscheepte	Verscheept
Verscherpen	Verscherpte	Verscherpt
Verscherven	Verscherfde	Verscherfd
Verschikken	Verschikte	Verschikt
Verschilferen	Verschilferde	Verschilferd
Verschoppen	Verschopte	Verschopt
Verschralen	Verschraalde	Verschraald
Verschranken	Verschrankte	Verschrankt
Verschrijven	Verschreef	Verschreven
Verschroeien	Verschroeide	Verschroeid
Verschroten	Verschrootte	Verschroot
Verschudden	Verschudde	Verschud
Verschutten	Verschutte	Verschut
Versificeren	Versificeerde	Geversificeerd
Versifiëren	Versifieerde	Geversifieerd
Versimpelen	Versimpelde	Versimpeld
Versjachelen	Versjachelde	Versjacheld
Versjacheren	Versjacherde	Versjacherd
Versjouwen	Versjouwde	Versjouwd
Versjteren	Versjteerde	Versjteerd
Verslampampen	Verslampampte	Verslampampt
Verslapen	Versliep	Verslapen
Verslaven	Verslaafde	Verslaafd
Verslechten	Verslechtte	Verslecht
Verslensen	Verslenste	Verslenst
Verslepen	Versleepte	Versleept
Versleuren	Versleurde	Versleurd
Verslibben	Verslibde	Verslibd
Verslijken	Verslijkte	Verslijkt
Verslijmen	Verslijmde	Verslijmd
Verslikken	Verslikte	Verslikt
Verslingeren	Verslingerde	Verslingerd
Verslodderen	Verslodderde	Verslodderd
Versloffen	Verslofte	Versloft
Verslonzen	Verslonsde	Verslonsd
Versluieren	Versluierde	Versluierd
Versluizen	Versluisde	Versluisd
Versmallen	Versmalde	Versmald
Versmeden	Versmeedde	Versmeed
Versmijten	Versmeet	Versmeten
Versmoren	Versmoorde	Versmoord
Versmullen	Versmulde	Versmuld
Versnipperen	Versnipperde	Versnipperd
Versnoepen	Versnoepte	Versnoept
Versoberen	Versoberde	Versoberd
Versoepelen	Versoepelde	Versoepeld
Versomberen	Versomberde	Versomberd
Verspaansen	Verspaanste	Verspaanst
Verspanen	Verspaande	Verspaand
Verspannen	Verspande	Verspannen
Verspelden	Verspeldde	Verspeld
Verspenen	Verspeende	Verspeend
Verspijkeren	Verspijkerde	Verspijkerd
Verspinnen	Verspon	Versponnen
Versplinteren	Versplinterde	Versplinterd
Verspreken	Versprak	Versproken
Verspringen	Versprong	Versprongen
Verstadsen	Verstadste	Verstadst
Verstalen	Verstaalde	Verstaald
Verstallen	Verstalde	Verstald
Verstappen	Verstapte	Verstapt
Verstarren	Verstarde	Verstard
Verstedelijken	Verstedelijkte	Verstedelijkt
Versteedsen	Versteedste	Versteedst
Versteken	Verstak	Verstoken
Verstempelen	Verstempelde	Verstempeld
Versterven	Verstierf	Verstorven
Verstieren	Verstierde	Verstierd
Verstillen	Verstilde	Verstild
Verstoelen	Verstoelde	Verstoeld
Verstoffelijken	Verstoffelijkte	Verstoffelijkt
Verstoken	Verstookte	Verstookt
Verstokken	Verstokte	Verstokt
Verstommen	Verstomde	Verstomd
Verstompen	Verstompte	Verstompt
Verstouten	Verstoutte	Verstout
Verstraffen	Verstrafte	Verstraft
Verstrakken	Verstrakte	Verstrakt
Verstrammen	Verstramde	Verstramd
Verstrengelen	Verstrengelde	Verstrengeld
Verstuiven	Verstoof	Verstoven
Verstuwen	Verstuwde	Verstuwd
Versuffen	Versufte	Versuft
Versuikeren	Versuikerde	Versuikerd
Versukkelen	Versukkelde	Versukkeld
Vertakelen	Vertakelde	Vertakeld
Vertakken	Vertakte	Vertakt
Vertappen	Vertapte	Vertapt
Vertassen	Vertaste	Vertast
Vertasten	Vertastte	Vertast
Vertederen	Vertederde	Vertederd
Vertekenen	Vertekende	Vertekend
Verteuten	Verteutte	Verteut
Vertienden	Vertiendde	Vertiend
Vertienvoudigen	Vertienvoudigde	Vertienvoudigd
Vertillen	Vertilde	Vertild
Vertimmeren	Vertimmerde	Vertimmerd
Vertinnen	Vertinde	Vertind
Vertonnen	Vertonde	Vertond
Vertrappelen	Vertrappelde	Vertrappeld
Vertreden	Vertrad	Vertreden
Vertreuzelen	Vertreuzelde	Vertreuzeld
Vertroebelen	Vertroebelde	Vertroebeld
Vertuien	Vertuide	Vertuid
Vertuisen	Vertuiste	Vertuist
Vertwijfelen	Vertwijfelde	Vertwijfeld
Veruiterlijken	Veruiterlijkte	Veruiterlijkt
Veruitwendigen	Veruitwendigde	Veruitwendigd
Vervagen	Vervaagde	Vervaagd
Vervalen	Vervaalde	Vervaald
Vervalsen	Vervalste	Vervalst
Vervaren	Vervaarde	Vervaard
Vervaren	Vervoer	Vervaren
Vervellen	Vervelde	Verveld
Vervenen	Verveende	Verveend
Verversen	Ververste	Ververst
Vervetten	Vervette	Vervet
Verviervoudigen	Verviervoudigde	Verviervoudigd
Vervijfvoudigen	Vervijfvoudigde	Vervijfvoudigd
Vervilten	Verviltte	Vervilt
Vervlaamsen	Vervlaamste	Vervlaamst
Vervlakken	Vervlakte	Vervlakt
Vervlechten	Vervlocht	Vervlochten
Vervlieden	Vervlood	Vervloden
Vervlieten	Vervloot	Vervloten
Vervloeien	Vervloeide	Vervloeid
Vervloeken	Vervloekte	Vervloekt
Vervoederen	Vervoederde	Vervoederd
Vervolledigen	Vervolledigde	Vervolledigd
Vervorderen	Vervorderde	Vervorderd
Vervrachten	Vervrachtte	Vervracht
Vervriezen	Vervroor	Vervroren
Vervrolijken	Vervrolijkte	Vervrolijkt
Vervrouwelijken	Vervrouwelijkte	Vervrouwelijkt
Vervuilen	Vervuilde	Vervuild
Vervuren	Vervuurde	Vervuurd
Verwaardigen	Verwaardigde	Verwaardigd
Verwaarlozen	Verwaarloosde	Verwaarloosd
Verwasemen	Verwasemde	Verwasemd
Verwassen	Verwaste	Verwassen
Verwassen	Verwies	Verwassen
Verwedden	Verwedde	Verwed
Verwegen	Verwoog	Verwogen
Verweiden	Verweidde	Verweid
Verwekelijken	Verwekelijkte	Verwekelijkt
Verweken	Verweekte	Verweekt
Verweldigen	Verweldigde	Verweldigd
Verwelven	Verwelfde	Verwelfd
Verwensen	Verwenste	Verwenst
Verwereldlijken	Verwereldlijkte	Verwereldlijkt
Verwesteren	Verwesterde	Verwesterd
Verwestersen	Verwesterste	Verwesterst
Verwetenschappelijken	Verwetenschappelijkte	Verwetenschappelijkt
Verweven	Verweefde	Verweven
Verwezen	Verweesde	Verweesd
Verwijden	Verwijdde	Verwijd
Verwijlen	Verwijlde	Verwijld
Verwijven	Verwijfde	Verwijfd
Verwijzen	Verwees	Verwezen
Verwilderen	Verwilderde	Verwilderd
Verwinden	Verwond	Verwonden
Verwinnen	Verwon	Verwonnen
Verwinteren	Verwinterde	Verwinterd
Verwonen	Verwoonde	Verwoond
Verworgen	Verworgde	Verworgd
Verwurgen	Verwurgde	Verwurgd
Verzaden	Verzaadde	Verzaad
Verzagen	Verzaagde	Verzaagd
Verzakelijken	Verzakelijkte	Verzakelijkt
Verzamen	Verzaamde	Verzaamd
Verzanden	Verzandde	Verzand
Verzeilen	Verzeilde	Verzeild
Verzelfstandigen	Verzelfstandigde	Verzelfstandigd
Verzellen	Verzelde	Verzeld
Verzengen	Verzengde	Verzengd
Verzepen	Verzeepte	Verzeept
Verzesvoudigen	Verzesvoudigde	Verzesvoudigd
Verzetten	Verzette	Verzet
Verzieden	Verziedde	Verzoden
Verzieken	Verziekte	Verziekt
Verzien	Verzag	Verzien
Verzilten	Verziltte	Verzilt
Verzilveren	Verzilverde	Verzilverd
Verzinnebeelden	Verzinnebeeldde	Verzinnebeeld
Verzitten	Verzat	Verzeten
Verzoenen	Verzoende	Verzoend
Verzolen	Verzoolde	Verzoold
Verzotten	Verzotte	Verzot
Verzouten	Verzoutte	Verzout
Verzouten	Verzoutte	Verzouten
Verzuchten	Verzuchtte	Verzucht
Verzuilen	Verzuilde	Verzuild
Verzuipen	Verzoop	Verzopen
Verzusteren	Verzusterde	Verzusterd
Verzwageren	Verzwagerde	Verzwagerd
Verzwaren	Verzwaarde	Verzwaard
Verzwendelen	Verzwendelde	Verzwendeld
Verzweren	Verzwoor	Verzworen
Verzwieren	Verzwierde	Verzwierd
Verzwijgen	Verzweeg	Verzwegen
Verzwijnen	Verzwijnde	Verzwijnd
Verzwikken	Verzwikte	Verzwikt
Verzwinden	Verzwond	Verzwonden
Vesten	Vestte	Gevest
Veteren	Veterde	Geveterd
Vetten	Vette	Gevet
Vetweiden	Vetweidde	Gevetweid
Vexeren	Vexeerde	Gevexeerd
Vezelen	Vezelde	Gevezeld
Vierendelen	Vierendeelde	Gevierendeeld
Vierkanten	Vierkantte	Gevierkant
Vigeren	Vigeerde	Gevigeerd
Vigileren	Vigileerde	Gevigileerd
Vijlen	Vijlde	Gevijld
Vijzelen	Vijzelde	Gevijzeld
Vijzen	Vees	Gevezen
Vindiceren	Vindiceerde	Gevindiceerd
Vingeren	Vingerde	Gevingerd
Vinken	Vinkte	Gevinkt
Vissen	Viste	Gevist
Vitamineren	Vitamineerde	Gevitamineerd
Vlaggen	Vlagde	Gevlagd
Vlakken	Vlakte	Gevlakt
Vlammen	Vlamde	Gevlamd
Vlassen	Vlaste	Gevlast
Vlechtbenen	Vlechtbeende	Gevlechtbeend
Vlechten	Vlocht	Gevlochten
Vleien	Vleide	Gevleid
Vletten	Vlette	Gevlet
Vlezen	Vleesde	Gevleesd
Vlieden	Vlood	Gevloden
Vliegen	Vloog	Gevlogen
Vliegeren	Vliegerde	Gevliegerd
Vlijmen	Vlijmde	Gevlijmd
Vlinderen	Vlinderde	Gevlinderd
Vloeken	Vloekte	Gevloekt
Vloeren	Vloerde	Gevloerd
Vlokken	Vlokte	Gevlokt
Vlooien	Vlooide	Gevlooid
Vluggeren	Vluggerde	Gevluggerd
Vocaliseren	Vocaliseerde	Gevocaliseerd
Vochten	Vochtte	Gevocht
Voeden	Voedde	Gevoed
Voedsteren	Voedsterde	Gevoedsterd
Voetballen	Voetbalde	Gevoetbald
Voeteren	Voeteerde	Gevoeteerd
Vogelen	Vogelde	Gevogeld
Vol	Volbouwde	Volbouwd
Volbrengen	Volbracht	Volbracht
Volgroeien	Volgroeide	Volgroeid
Volksdansen	Volksdanste	Gevolksdanst
Vollen	Volde	Gevold
Volleren	Volleerde	Gevolleerd
Volleyballen	Volleybalde	Gevolleybald
Volleyen	Volleyde	Gevolleyd
Volmachtigen	Volmachtigde	Gevolmachtigd
Voltekenen	Voltekende	Voltekend
Vonkelen	Vonkelde	Gevonkeld
Vonken	Vonkte	Gevonkt
Vooronderstellen	Vooronderstelde	Voorondersteld
Voorvoelen	Voorvoelde	Voorvoeld
Vossen	Voste	Gevost
Voteren	Voteerde	Gevoteerd
Vozen	Voosde	Gevoosd
Vriesdrogen	Vriesdroogde	Gevriesdroogd
Vriezen	Vroor	Gevroren
Vrijbuiten	Vrijbuitte	Gevrijbuit
Vrijwielen	Vrijwielde	Gevrijwield
Vuilbekken	Vuilbekte	Gevuilbekt
Vulgariseren	Vulgariseerde	Gevulgariseerd
Vulkaniseren	Vulkaniseerde	Gevulkaniseerd
Vutten	Vutte	Gevut
Waaieren	Waaierde	Gewaaierd
Waggelbenen	Waggelbeende	Gewaggelbeend
Walen	Waalde	Gewaald
Walgen	Walgde	Gewalgd
Walken	Walkte	Gewalkt
Wallebakken	Wallebakte	Gewallebakt
Wallen	Walde	Gewald
Walmen	Walmde	Gewalmd
Walsen	Walste	Gewalst
Wamen	Waamde	Gewaamd
Wammen	Wamde	Gewamd
Wanboffen	Wanbofte	Gewanboft
Wanen	Waande	Gewaand
Wanten	Wantte	Gewant
Wantrouwen	Wantrouwde	Gewantrouwd
Warrelen	Warrelde	Gewarreld
Warren	Warde	Geward
Wasemen	Wasemde	Gewasemd
Waterfietsen	Waterfietste	Gewaterfietst
Watergolven	Watergolfde	Gewatergolfd
Waterpassen	Waterpaste	Gewaterpast
Waterskiën	Waterskiede	Gewaterskied
Watertanden	Watertandde	Gewatertand
Watteren	Watteerde	Gewatteerd
Wauwelen	Wauwelde	Gewauweld
Wecken	Weckte	Geweckt
Wedden	Wedde	Gewed
Wedervaren	Wedervoer	Wedervaren
Weekeinden	Weekeindde	Geweekeind
Weekenden	Weekendde	Geweekend
Weeklagen	Weeklaagde	Geweeklaagd
Weerlichten	Weerlichtte	Geweerlicht
Weerschijnen	Weerscheen	Weerschenen
Weerspreken	Weersprak	Weersproken
Weerstreven	Weerstreefde	Weerstreefd
Wegbelasten	Wegbelastte	Wegbelast
Wegeren	Wegerde	Gewegerd
Welken	Welkte	Gewelkt
Wellen	Welde	Geweld
Welven	Welfde	Gewelfd
Wenken	Wenkte	Gewenkt
Weren	Weerde	Geweerd
Wervelen	Wervelde	Gewerveld
Westelijken	Westelijkte	Gewestelijkt
Weten	Wist	Geweten
Weven	Weefde	Geweven
Wezen	Was	Geweest
Whisten	Whistte	Gewhist
Wichelen	Wichelde	Gewicheld
Wieberen	Wieberde	Gewieberd
Wieken	Wiekte	Gewiekt
Wielen	Wielde	Gewield
Wiemelen	Wiemelde	Gewiemeld
Wieroken	Wierookte	Gewierookt
Wiewauwen	Wiewauwde	Gewiewauwd
Wiggelen	Wiggelde	Gewiggeld
Wijlen	Wijlde	Gewijld
Wildwaterkanoën	Wildwaterkanode	Gewildwaterkanood
Willigen	Willigde	Gewilligd
Windsurfen	Windsurfte	Gewindsurft
Winkelen	Winkelde	Gewinkeld
Winteren	Winterde	Gewinterd
Wispelen	Wispelde	Gewispeld
Wispelstaarten	Wispelstaartte	Gewispelstaart
Woeden	Woedde	Gewoed
Wokken	Wokte	Gewokt
Wolmaniseren	Wolmaniseerde	Gewolmaniseerd
Wolven	Wolfde	Gewolfd
Wonderen	Wonderde	Gewonderd
Workshoppen	Workshopte	Geworkshopt
Wortelen	Wortelde	Geworteld
Worteltrekken		
Wrensen	Wrenste	Gewrenst
Wriggelen	Wriggelde	Gewriggeld
Wrikkelen	Wrikkelde	Gewrikkeld
Wrochten	Wrochtte	Gewrocht
Wroegen	Wroegde	Gewroegd
Wrokken	Wrokte	Gewrokt
Wrongelen	Wrongelde	Gewrongeld
Wuiven	Wuifde	Gewuifd
Wurmen	Wurmde	Gewurmd
Xeroxen	Xeroxte	Gexeroxt
Yahtzeeën	Yahtzeede	Geyahtzeed
Yellen	Yelde	Geyeld
Zabbelen	Zabbelde	Gezabbeld
Zabberen	Zabberde	Gezabberd
Zagen	Zaagde	Gezaagd
Zaligen	Zaligde	Gezaligd
Zamelen	Zamelde	Gezameld
Zanden	Zandde	Gezand
Zandstralen	Zandstraalde	Gezandstraald
Zaniken	Zanikte	Gezanikt
Zanten	Zantte	Gezant
Zappen	Zapte	Gezapt
Zeefdrukken	Zeefdrukte	Gezeefdrukt
Zegepralen	Zegepraalde	Gezegepraald
Zeilen	Zeilde	Gezeild
Zekeren	Zekerde	Gezekerd
Zemelen	Zemelde	Gezemeld
Zemelknopen	Zemelknoopte	Gezemelknoopt
Zemen	Zeemde	Gezeemd
Zenderhoppen	Zenderhopte	Gezenderhopt
Zengen	Zengde	Gezengd
Zetelen	Zetelde	Gezeteld
Zeulen	Zeulde	Gezeuld
Zeuren	Zeurde	Gezeurd
Zeveren	Zeverde	Gezeverd
Ziegezagen	Ziegezaagde	Geziegezaagd
Zieken	Ziekte	Geziekt
Zieltogen	Zieltoogde	Gezieltoogd
Zigzaggen	Zigzagde	Gezigzagd
Zijn	Was	Geweest
Zijpelen	Zijpelde	Gezijpeld
Zinderen	Zinderde	Gezinderd
Zingen	Zong	Gezongen
Zippen	Zipte	Gezipt
Zoetvijlen	Zoetvijlde	Gezoetvijld
Zoeven	Zoefde	Gezoefd
Zolderen	Zolderde	Gezolderd
Zolen	Zoolde	Gezoold
Zomen	Zoomde	Gezoomd
Zomeren	Zomerde	Gezomerd
Zoomen	Zoomde	Gezoomd
Zottebollen	Zottebolde	Gezottebold
Zuidelijken	Zuidelijkte	Gezuidelijkt
Zuimen	Zuimde	Gezuimd
Zuipen	Zoop	Gezopen
Zullen	Zou	
Zulten	Zultte	Gezult
Zuren	Zuurde	Gezuurd
Zwabberen	Zwabberde	Gezwabberd
Zwalken	Zwalkte	Gezwalkt
Zwalpen	Zwalpte	Gezwalpt
Zwaluwstaarten	Zwaluwstaartte	Gezwaluwstaart
Zwammen	Zwamde	Gezwamd
Zwanzen	Zwansde	Gezwansd
Zwartepieten	Zwartepiette	Gezwartepiet
Zwartselen	Zwartselde	Gezwartseld
Zwatelen	Zwatelde	Gezwateld
Zwavelen	Zwavelde	Gezwaveld
Zweden	Zweedde	Gezweed
Zwelen	Zweelde	Gezweeld
Zwelgen	Zwolg	Gezwolgen
Zwemen	Zweemde	Gezweemd
Zwengelen	Zwengelde	Gezwengeld
Zweven	Zweefde	Gezweefd
Zwiepen	Zwiepte	Gezwiept
Zwierbollen	Zwierbolde	Gezwierbold
Zwieren	Zwierde	Gezwierd
Zwijmelen	Zwijmelde	Gezwijmeld
Zwijmen	Zwijmde	Gezwijmd
Zwikken	Zwikte	Gezwikt
Zwingelen	Zwingelde	Gezwingeld
Zwirrelen	Zwirrelde	Gezwirreld
